ship_id,berth,arrival_time,containers_dropped_off,containers_loaded,operation_time,departure_time
S3542705,1,2024-10-13 19:01:04,4,4,8,2024-10-13 19:09:04
S7834667,2,2024-10-13 19:04:46,1,16,17,2024-10-13 19:21:46
S7891383,1,2024-10-13 19:09:14,1,11,12,2024-10-13 19:21:14
S8225602,3,2024-10-13 19:12:33,1,1,2,2024-10-13 19:14:33
S2148011,3,2024-10-13 19:17:25,1,72,73,2024-10-13 20:30:25
S4921232,1,2024-10-13 19:29:54,4,12,16,2024-10-13 19:45:54
S3867679,2,2024-10-13 19:33:52,7,33,40,2024-10-13 20:13:52
S3362550,1,2024-10-13 19:46:58,2,16,18,2024-10-13 20:04:58
S9970044,4,2024-10-13 19:47:24,4,38,42,2024-10-13 20:29:24
S3942463,5,2024-10-13 19:55:11,5,2,7,2024-10-13 20:02:11
S4324690,5,2024-10-13 20:03:58,3,13,16,2024-10-13 20:19:58
S8617514,1,2024-10-13 20:10:16,1,1,2,2024-10-13 20:12:16
S7242845,1,2024-10-13 20:13:14,9,12,21,2024-10-13 20:34:14
S7146229,2,2024-10-13 20:17:01,1,41,42,2024-10-13 20:59:01
S8178303,5,2024-10-13 20:20:24,8,10,18,2024-10-13 20:38:24
S5639940,3,2024-10-13 20:30:41,6,26,32,2024-10-13 21:02:41
S1800547,4,2024-10-13 20:31:04,2,6,8,2024-10-13 20:39:04
S8246338,1,2024-10-13 20:36:42,4,16,20,2024-10-13 20:56:42
S8509755,4,2024-10-13 20:40:16,3,46,49,2024-10-13 21:29:16
S1265479,5,2024-10-13 20:42:15,8,23,31,2024-10-13 21:13:15
S9762496,1,2024-10-13 20:58:20,7,15,22,2024-10-13 21:20:20
S2901623,1,2024-10-13 21:20:49,3,71,74,2024-10-13 22:34:49
S8776777,2,2024-10-13 21:22:09,10,21,31,2024-10-13 21:53:09
S4062619,3,2024-10-13 21:27:06,6,7,13,2024-10-13 21:40:06
S0171464,4,2024-10-13 21:29:51,3,3,6,2024-10-13 21:35:51
S1738638,5,2024-10-13 21:32:46,8,5,13,2024-10-13 21:45:46
S3841447,3,2024-10-13 21:40:39,1,43,44,2024-10-13 22:24:39
S6945217,4,2024-10-13 21:42:10,6,14,20,2024-10-13 22:02:10
S5902180,5,2024-10-13 21:47:03,4,23,27,2024-10-13 22:14:03
S6986626,2,2024-10-13 22:04:57,8,32,40,2024-10-13 22:44:57
S7432916,4,2024-10-13 22:05:09,5,13,18,2024-10-13 22:23:09
S5422961,3,2024-10-13 22:26:03,2,1,3,2024-10-13 22:29:03
S8176405,4,2024-10-13 22:27:43,2,4,6,2024-10-13 22:33:43
S5747319,3,2024-10-13 22:30:32,9,5,14,2024-10-13 22:44:32
S7200769,1,2024-10-13 22:42:21,1,37,38,2024-10-13 23:20:21
S1782701,2,2024-10-13 22:49:56,9,14,23,2024-10-13 23:12:56
S2211843,3,2024-10-13 22:56:26,11,11,22,2024-10-13 23:18:26
S8348947,4,2024-10-13 23:07:56,7,9,16,2024-10-13 23:23:56
S0096604,5,2024-10-13 23:08:17,3,14,17,2024-10-13 23:25:17
S3744721,2,2024-10-13 23:13:20,7,32,39,2024-10-13 23:52:20
S1436472,1,2024-10-13 23:23:06,5,15,20,2024-10-13 23:43:06
S9778486,3,2024-10-13 23:27:07,1,15,16,2024-10-13 23:43:07
S1647502,4,2024-10-13 23:27:27,5,20,25,2024-10-13 23:52:27
S2343435,5,2024-10-13 23:28:01,13,40,53,2024-10-14 00:21:01
S4103669,1,2024-10-13 23:43:18,8,3,11,2024-10-13 23:54:18
S3514693,1,2024-10-13 23:56:12,6,34,40,2024-10-14 00:36:12
S6414930,2,2024-10-14 00:05:44,2,6,8,2024-10-14 00:13:44
S6724649,2,2024-10-14 00:27:29,2,5,7,2024-10-14 00:34:29
S0636259,3,2024-10-14 00:30:44,5,7,12,2024-10-14 00:42:44
S9573316,4,2024-10-14 00:31:55,5,34,39,2024-10-14 01:10:55
S1945625,2,2024-10-14 00:35:33,4,14,18,2024-10-14 00:53:33
S8268078,1,2024-10-14 00:36:45,7,15,22,2024-10-14 00:58:45
S2677081,5,2024-10-14 00:41:26,2,1,3,2024-10-14 00:44:26
S9541012,3,2024-10-14 00:43:27,10,7,17,2024-10-14 01:00:27
S2556044,5,2024-10-14 00:47:51,10,19,29,2024-10-14 01:16:51
S3070649,2,2024-10-14 00:54:09,6,12,18,2024-10-14 01:12:09
S6913821,1,2024-10-14 01:03:14,2,58,60,2024-10-14 02:03:14
S0789679,3,2024-10-14 01:10:17,2,17,19,2024-10-14 01:29:17
S6566465,2,2024-10-14 01:17:09,3,12,15,2024-10-14 01:32:09
S2818827,4,2024-10-14 01:18:07,4,22,26,2024-10-14 01:44:07
S2092982,5,2024-10-14 01:18:21,4,2,6,2024-10-14 01:24:21
S6890968,5,2024-10-14 01:26:32,4,1,5,2024-10-14 01:31:32
S7424136,2,2024-10-14 01:41:31,1,10,11,2024-10-14 01:52:31
S1011118,3,2024-10-14 01:46:24,7,11,18,2024-10-14 02:04:24
S7561136,4,2024-10-14 01:48:09,5,6,11,2024-10-14 01:59:09
S3075211,2,2024-10-14 01:55:53,8,10,18,2024-10-14 02:13:53
S1244395,5,2024-10-14 01:58:34,10,1,11,2024-10-14 02:09:34
S6668220,4,2024-10-14 02:00:08,2,25,27,2024-10-14 02:27:08
S1650324,1,2024-10-14 02:15:46,3,52,55,2024-10-14 03:10:46
S6841098,2,2024-10-14 02:20:58,9,10,19,2024-10-14 02:39:58
S4247981,3,2024-10-14 02:26:42,7,16,23,2024-10-14 02:49:42
S6570666,4,2024-10-14 02:27:42,3,2,5,2024-10-14 02:32:42
S9851054,4,2024-10-14 02:33:55,5,1,6,2024-10-14 02:39:55
S9731172,2,2024-10-14 02:41:49,8,6,14,2024-10-14 02:55:49
S4370361,4,2024-10-14 02:42:08,11,10,21,2024-10-14 03:03:08
S0824560,5,2024-10-14 02:44:28,9,17,26,2024-10-14 03:10:28
S3011171,2,2024-10-14 03:01:25,7,1,8,2024-10-14 03:09:25
S6288533,3,2024-10-14 03:03:28,6,89,95,2024-10-14 04:38:28
S5247188,1,2024-10-14 03:12:24,9,20,29,2024-10-14 03:41:24
S9741739,2,2024-10-14 03:16:01,6,13,19,2024-10-14 03:35:01
S7637121,4,2024-10-14 03:19:42,5,29,34,2024-10-14 03:53:42
S4061701,5,2024-10-14 03:25:56,6,37,43,2024-10-14 04:08:56
S0779971,2,2024-10-14 03:35:15,5,15,20,2024-10-14 03:55:15
S9830946,1,2024-10-14 03:42:09,9,57,66,2024-10-14 04:48:09
S4388708,2,2024-10-14 03:58:52,1,7,8,2024-10-14 04:06:52
S4312768,4,2024-10-14 04:03:46,13,10,23,2024-10-14 04:26:46
S4148906,2,2024-10-14 04:08:52,3,22,25,2024-10-14 04:33:52
S4280218,5,2024-10-14 04:12:55,8,6,14,2024-10-14 04:26:55
S1912906,4,2024-10-14 04:29:32,12,2,14,2024-10-14 04:43:32
S3248442,2,2024-10-14 04:34:48,6,52,58,2024-10-14 05:32:48
S7700000,3,2024-10-14 04:41:03,3,5,8,2024-10-14 04:49:03
S1448246,5,2024-10-14 04:42:09,3,3,6,2024-10-14 04:48:09
S8707502,4,2024-10-14 04:46:40,1,5,6,2024-10-14 04:52:40
S4662076,1,2024-10-14 04:49:49,14,36,50,2024-10-14 05:39:49
S7152461,3,2024-10-14 04:53:39,10,4,14,2024-10-14 05:07:39
S5863576,4,2024-10-14 05:02:12,3,47,50,2024-10-14 05:52:12
S2905179,5,2024-10-14 05:07:11,3,26,29,2024-10-14 05:36:11
S7827330,3,2024-10-14 05:17:21,2,31,33,2024-10-14 05:50:21
S0034549,2,2024-10-14 05:36:48,2,10,12,2024-10-14 05:48:48
S0231774,1,2024-10-14 05:53:05,5,15,20,2024-10-14 06:13:05
S1966951,2,2024-10-14 05:54:29,10,4,14,2024-10-14 06:08:29
S1828325,3,2024-10-14 05:55:36,8,4,12,2024-10-14 06:07:36
S6874752,4,2024-10-14 05:57:02,2,2,4,2024-10-14 06:01:02
S7882586,2,2024-10-14 06:10:41,3,1,4,2024-10-14 06:14:41
S3330246,1,2024-10-14 06:13:35,4,4,8,2024-10-14 06:21:35
S9073647,2,2024-10-14 06:21:01,6,6,12,2024-10-14 06:33:01
S6849210,3,2024-10-14 06:21:04,5,8,13,2024-10-14 06:34:04
S9864531,1,2024-10-14 06:24:18,12,11,23,2024-10-14 06:47:18
S8792216,4,2024-10-14 06:28:57,8,19,27,2024-10-14 06:55:57
S8602307,5,2024-10-14 06:32:39,9,4,13,2024-10-14 06:45:39
S8799574,2,2024-10-14 06:40:02,3,5,8,2024-10-14 06:48:02
S0555302,1,2024-10-14 06:52:59,5,20,25,2024-10-14 07:17:59
S1322271,2,2024-10-14 06:55:01,5,2,7,2024-10-14 07:02:01
S2918557,3,2024-10-14 06:55:27,1,44,45,2024-10-14 07:40:27
S1494964,2,2024-10-14 07:04:22,1,1,2,2024-10-14 07:06:22
S3839341,4,2024-10-14 07:06:05,12,21,33,2024-10-14 07:39:05
S1474699,2,2024-10-14 07:07:12,6,28,34,2024-10-14 07:41:12
S5595809,5,2024-10-14 07:10:45,6,6,12,2024-10-14 07:22:45
S7280156,1,2024-10-14 07:18:12,3,25,28,2024-10-14 07:46:12
S3063525,5,2024-10-14 07:23:47,9,21,30,2024-10-14 07:53:47
S0464247,1,2024-10-14 07:47:10,8,31,39,2024-10-14 08:26:10
S5946862,2,2024-10-14 07:55:13,10,31,41,2024-10-14 08:36:13
S5877968,3,2024-10-14 08:03:16,5,20,25,2024-10-14 08:28:16
S5013638,4,2024-10-14 08:10:44,5,14,19,2024-10-14 08:29:44
S2462256,5,2024-10-14 08:12:42,6,3,9,2024-10-14 08:21:42
S8168934,5,2024-10-14 08:25:55,7,22,29,2024-10-14 08:54:55
S9277595,1,2024-10-14 08:28:54,8,17,25,2024-10-14 08:53:54
S7378135,3,2024-10-14 08:33:46,4,3,7,2024-10-14 08:40:46
S6065898,2,2024-10-14 08:43:23,7,8,15,2024-10-14 08:58:23
S3324915,3,2024-10-14 08:44:39,14,8,22,2024-10-14 09:06:39
S2916217,4,2024-10-14 08:51:35,7,13,20,2024-10-14 09:11:35
S2745558,1,2024-10-14 08:57:03,6,21,27,2024-10-14 09:24:03
S6216970,2,2024-10-14 09:04:39,2,9,11,2024-10-14 09:15:39
S4321159,3,2024-10-14 09:07:27,2,57,59,2024-10-14 10:06:27
S5680988,2,2024-10-14 09:18:26,8,2,10,2024-10-14 09:28:26
S5898666,4,2024-10-14 09:18:57,10,44,54,2024-10-14 10:12:57
S4469912,5,2024-10-14 09:22:03,14,10,24,2024-10-14 09:46:03
S0871144,1,2024-10-14 09:30:36,1,9,10,2024-10-14 09:40:36
S3288121,2,2024-10-14 09:33:40,8,4,12,2024-10-14 09:45:40
S1707498,1,2024-10-14 09:44:03,4,1,5,2024-10-14 09:49:03
S6710132,2,2024-10-14 09:46:24,4,50,54,2024-10-14 10:40:24
S6791969,1,2024-10-14 09:50:35,8,5,13,2024-10-14 10:03:35
S3437787,5,2024-10-14 09:51:50,2,11,13,2024-10-14 10:04:50
S0011749,1,2024-10-14 10:07:10,6,9,15,2024-10-14 10:22:10
S2351560,1,2024-10-14 10:22:27,3,7,10,2024-10-14 10:32:27
S2086571,1,2024-10-14 10:39:55,13,12,25,2024-10-14 11:04:55
S8963260,2,2024-10-14 10:43:08,11,17,28,2024-10-14 11:11:08
S3671970,3,2024-10-14 10:51:16,1,8,9,2024-10-14 11:00:16
S0275016,1,2024-10-14 11:16:55,6,19,25,2024-10-14 11:41:55
S3293399,2,2024-10-14 11:23:39,2,2,4,2024-10-14 11:27:39
S8469843,2,2024-10-14 11:37:50,9,21,30,2024-10-14 12:07:50
S4983438,1,2024-10-14 11:45:29,6,5,11,2024-10-14 11:56:29
S3308339,1,2024-10-14 11:58:08,1,19,20,2024-10-14 12:18:08
S3198623,3,2024-10-14 12:01:40,3,12,15,2024-10-14 12:16:40
S9941565,4,2024-10-14 12:02:54,6,19,25,2024-10-14 12:27:54
S3333977,1,2024-10-14 12:22:15,14,20,34,2024-10-14 12:56:15
S7725676,2,2024-10-14 12:25:46,4,7,11,2024-10-14 12:36:46
S5620583,3,2024-10-14 12:26:28,2,30,32,2024-10-14 12:58:28
S8639707,5,2024-10-14 12:26:48,8,7,15,2024-10-14 12:41:48
S0482897,4,2024-10-14 12:30:22,7,6,13,2024-10-14 12:43:22
S7507516,2,2024-10-14 12:48:22,6,3,9,2024-10-14 12:57:22
S3862095,4,2024-10-14 12:53:46,10,1,11,2024-10-14 13:04:46
S1581242,1,2024-10-14 13:03:36,8,6,14,2024-10-14 13:17:36
S0473101,2,2024-10-14 13:10:26,3,13,16,2024-10-14 13:26:26
S8957687,1,2024-10-14 13:21:28,3,7,10,2024-10-14 13:31:28
S1170974,3,2024-10-14 13:25:55,3,1,4,2024-10-14 13:29:55
S0557218,1,2024-10-14 13:33:16,10,17,27,2024-10-14 14:00:16
S8576500,2,2024-10-14 13:49:28,15,16,31,2024-10-14 14:20:28
S7747105,3,2024-10-14 13:50:51,5,4,9,2024-10-14 13:59:51
S7168381,4,2024-10-14 13:55:50,8,7,15,2024-10-14 14:10:50
S7954335,5,2024-10-14 13:56:40,3,1,4,2024-10-14 14:00:40
S9996163,1,2024-10-14 14:00:43,5,4,9,2024-10-14 14:09:43
S1478291,3,2024-10-14 14:02:36,3,19,22,2024-10-14 14:24:36
S2332549,5,2024-10-14 14:06:33,8,7,15,2024-10-14 14:21:33
S7948302,1,2024-10-14 14:16:27,9,10,19,2024-10-14 14:35:27
S7599242,4,2024-10-14 14:20:22,8,15,23,2024-10-14 14:43:22
S7640643,2,2024-10-14 14:24:57,4,24,28,2024-10-14 14:52:57
S2020543,1,2024-10-14 14:38:24,3,55,58,2024-10-14 15:36:24
S3432460,3,2024-10-14 14:50:11,9,12,21,2024-10-14 15:11:11
S9350075,2,2024-10-14 14:56:44,5,10,15,2024-10-14 15:11:44
S2266735,4,2024-10-14 14:57:15,1,16,17,2024-10-14 15:14:15
S8059592,5,2024-10-14 15:11:10,9,13,22,2024-10-14 15:33:10
S5730020,2,2024-10-14 15:17:51,2,2,4,2024-10-14 15:21:51
S9733887,1,2024-10-14 15:49:07,1,15,16,2024-10-14 16:05:07
S0656025,2,2024-10-14 15:54:07,2,4,6,2024-10-14 16:00:07
S4842817,3,2024-10-14 15:58:00,1,24,25,2024-10-14 16:23:00
S0297693,1,2024-10-14 16:09:30,5,3,8,2024-10-14 16:17:30
S3823107,2,2024-10-14 16:09:56,4,31,35,2024-10-14 16:44:56
S4818967,1,2024-10-14 16:21:24,2,18,20,2024-10-14 16:41:24
S9463387,3,2024-10-14 16:35:45,3,42,45,2024-10-14 17:20:45
S1704945,1,2024-10-14 16:44:30,6,7,13,2024-10-14 16:57:30
S5707042,2,2024-10-14 16:45:09,2,2,4,2024-10-14 16:49:09
S0764643,4,2024-10-14 16:46:41,1,5,6,2024-10-14 16:52:41
S5803586,1,2024-10-14 16:57:54,7,23,30,2024-10-14 17:27:54
S9363425,2,2024-10-14 17:04:12,2,6,8,2024-10-14 17:12:12
S0415274,4,2024-10-14 17:04:30,5,5,10,2024-10-14 17:14:30
S7555942,5,2024-10-14 17:12:08,10,2,12,2024-10-14 17:24:08
S2033603,2,2024-10-14 17:17:52,4,8,12,2024-10-14 17:29:52
S8964212,4,2024-10-14 17:20:01,11,11,22,2024-10-14 17:42:01
S4947602,3,2024-10-14 17:23:21,9,2,11,2024-10-14 17:34:21
S9163413,5,2024-10-14 17:25:53,9,19,28,2024-10-14 17:53:53
S9735723,1,2024-10-14 17:32:05,2,1,3,2024-10-14 17:35:05
S7185160,2,2024-10-14 17:32:30,5,34,39,2024-10-14 18:11:30
S9296752,3,2024-10-14 17:34:30,1,8,9,2024-10-14 17:43:30
S4758608,1,2024-10-14 17:58:08,10,18,28,2024-10-14 18:26:08
S4680823,3,2024-10-14 18:03:47,4,18,22,2024-10-14 18:25:47
S1623473,4,2024-10-14 18:09:03,8,11,19,2024-10-14 18:28:03
S6651423,5,2024-10-14 18:10:19,11,16,27,2024-10-14 18:37:19
S2702917,1,2024-10-14 18:39:23,9,8,17,2024-10-14 18:56:23
S5385343,2,2024-10-14 18:40:40,4,8,12,2024-10-14 18:52:40
S9933470,2,2024-10-14 18:54:38,10,6,16,2024-10-14 19:10:38
S4590541,1,2024-10-14 18:59:49,8,16,24,2024-10-14 19:23:49
S6903557,3,2024-10-14 19:02:44,3,9,12,2024-10-14 19:14:44
S7215856,4,2024-10-14 19:07:39,9,13,22,2024-10-14 19:29:39
S7069566,2,2024-10-14 19:14:22,8,5,13,2024-10-14 19:27:22
S1215671,3,2024-10-14 19:17:38,2,12,14,2024-10-14 19:31:38
S8150641,5,2024-10-14 19:19:58,10,33,43,2024-10-14 20:02:58
S9014453,1,2024-10-14 19:31:13,1,6,7,2024-10-14 19:38:13
S6099432,2,2024-10-14 19:36:08,2,2,4,2024-10-14 19:40:08
S3733669,1,2024-10-14 19:39:12,3,9,12,2024-10-14 19:51:12
S3216616,1,2024-10-14 19:55:43,5,7,12,2024-10-14 20:07:43
S8331583,1,2024-10-14 20:20:53,1,1,2,2024-10-14 20:22:53
S0733723,1,2024-10-14 20:23:18,4,30,34,2024-10-14 20:57:18
S9280351,2,2024-10-14 20:23:49,2,31,33,2024-10-14 20:56:49
S3858292,3,2024-10-14 20:24:39,2,1,3,2024-10-14 20:27:39
S8884328,3,2024-10-14 20:35:33,9,9,18,2024-10-14 20:53:33
S6571967,4,2024-10-14 20:43:06,3,3,6,2024-10-14 20:49:06
S5954879,4,2024-10-14 20:50:13,6,2,8,2024-10-14 20:58:13
S0424868,3,2024-10-14 20:56:40,9,10,19,2024-10-14 21:15:40
S2225247,1,2024-10-14 21:02:41,10,47,57,2024-10-14 21:59:41
S8604452,2,2024-10-14 21:08:21,8,13,21,2024-10-14 21:29:21
S7062896,3,2024-10-14 21:24:16,5,5,10,2024-10-14 21:34:16
S7230166,2,2024-10-14 21:33:30,6,118,124,2024-10-14 23:37:30
S4915242,3,2024-10-14 21:38:22,11,78,89,2024-10-14 23:07:22
S4267787,4,2024-10-14 21:40:10,6,29,35,2024-10-14 22:15:10
S2565748,5,2024-10-14 21:47:47,2,3,5,2024-10-14 21:52:47
S0026954,1,2024-10-14 22:24:15,8,5,13,2024-10-14 22:37:15
S5675467,4,2024-10-14 22:31:24,3,2,5,2024-10-14 22:36:24
S2318451,5,2024-10-14 22:34:25,6,19,25,2024-10-14 22:59:25
S3772250,1,2024-10-14 22:38:58,7,43,50,2024-10-14 23:28:58
S3158752,4,2024-10-14 22:59:16,1,1,2,2024-10-14 23:01:16
S8792973,5,2024-10-14 23:00:48,7,15,22,2024-10-14 23:22:48
S5188408,3,2024-10-14 23:21:09,4,1,5,2024-10-14 23:26:09
S6347729,4,2024-10-14 23:22:59,8,2,10,2024-10-14 23:32:59
S2230529,1,2024-10-14 23:36:43,2,41,43,2024-10-15 00:19:43
S5430913,2,2024-10-14 23:41:40,3,22,25,2024-10-15 00:06:40
S3417770,3,2024-10-14 23:51:28,1,1,2,2024-10-14 23:53:28
S0512939,3,2024-10-14 23:56:23,5,4,9,2024-10-15 00:05:23
S7035242,4,2024-10-15 00:00:48,5,3,8,2024-10-15 00:08:48
S3653314,2,2024-10-15 00:09:49,10,66,76,2024-10-15 01:25:49
S5099295,3,2024-10-15 00:17:47,2,67,69,2024-10-15 01:26:47
S2112005,1,2024-10-15 00:27:40,9,26,35,2024-10-15 01:02:40
S1193381,4,2024-10-15 00:31:13,4,20,24,2024-10-15 00:55:13
S2301383,5,2024-10-15 00:32:23,2,25,27,2024-10-15 00:59:23
S0695031,1,2024-10-15 01:07:44,6,10,16,2024-10-15 01:23:44
S3728367,4,2024-10-15 01:09:09,3,5,8,2024-10-15 01:17:09
S5187049,5,2024-10-15 01:11:42,1,21,22,2024-10-15 01:33:42
S2852079,4,2024-10-15 01:23:37,2,11,13,2024-10-15 01:36:37
S0735556,1,2024-10-15 01:42:30,6,3,9,2024-10-15 01:51:30
S4618932,2,2024-10-15 01:47:26,1,29,30,2024-10-15 02:17:26
S1085322,3,2024-10-15 01:50:42,11,22,33,2024-10-15 02:23:42
S4033263,1,2024-10-15 02:07:27,11,38,49,2024-10-15 02:56:27
S1025895,4,2024-10-15 02:08:24,4,4,8,2024-10-15 02:16:24
S5681698,5,2024-10-15 02:11:20,1,3,4,2024-10-15 02:15:20
S0615629,4,2024-10-15 02:17:09,6,1,7,2024-10-15 02:24:09
S0338736,2,2024-10-15 02:27:54,5,28,33,2024-10-15 03:00:54
S1754755,3,2024-10-15 02:28:03,5,9,14,2024-10-15 02:42:03
S4980064,3,2024-10-15 02:54:10,1,8,9,2024-10-15 03:03:10
S2727112,1,2024-10-15 03:01:24,3,1,4,2024-10-15 03:05:24
S9136537,1,2024-10-15 03:12:22,3,13,16,2024-10-15 03:28:22
S8463237,2,2024-10-15 03:20:58,2,13,15,2024-10-15 03:35:58
S5798616,1,2024-10-15 03:32:31,9,2,11,2024-10-15 03:43:31
S9789064,2,2024-10-15 03:39:45,7,16,23,2024-10-15 04:02:45
S1606185,3,2024-10-15 03:40:00,2,6,8,2024-10-15 03:48:00
S8326275,4,2024-10-15 03:40:23,8,55,63,2024-10-15 04:43:23
S5216197,5,2024-10-15 03:41:02,3,37,40,2024-10-15 04:21:02
S5516503,1,2024-10-15 03:51:10,3,3,6,2024-10-15 03:57:10
S8656129,3,2024-10-15 03:52:11,6,10,16,2024-10-15 04:08:11
S5207712,1,2024-10-15 04:03:51,12,36,48,2024-10-15 04:51:51
S3689541,2,2024-10-15 04:05:55,3,3,6,2024-10-15 04:11:55
S2490487,2,2024-10-15 04:22:51,7,75,82,2024-10-15 05:44:51
S6409776,3,2024-10-15 04:38:34,6,5,11,2024-10-15 04:49:34
S8208156,3,2024-10-15 04:50:47,4,104,108,2024-10-15 06:38:47
S0941130,1,2024-10-15 04:56:26,10,28,38,2024-10-15 05:34:26
S9186781,4,2024-10-15 05:09:04,5,13,18,2024-10-15 05:27:04
S1735119,5,2024-10-15 05:13:41,7,10,17,2024-10-15 05:30:41
S0438315,1,2024-10-15 05:45:04,5,36,41,2024-10-15 06:26:04
S7895802,2,2024-10-15 05:45:22,12,12,24,2024-10-15 06:09:22
S5862249,4,2024-10-15 05:57:56,4,2,6,2024-10-15 06:03:56
S0773481,2,2024-10-15 06:09:54,7,64,71,2024-10-15 07:20:54
S8178842,4,2024-10-15 06:23:15,13,12,25,2024-10-15 06:48:15
S6933005,1,2024-10-15 06:36:16,13,27,40,2024-10-15 07:16:16
S5169957,3,2024-10-15 06:46:57,1,5,6,2024-10-15 06:52:57
S4765747,5,2024-10-15 06:47:53,3,9,12,2024-10-15 06:59:53
S4913746,4,2024-10-15 06:50:05,8,14,22,2024-10-15 07:12:05
S5964381,3,2024-10-15 06:53:16,10,76,86,2024-10-15 08:19:16
S8929139,5,2024-10-15 07:06:22,2,29,31,2024-10-15 07:37:22
S7964502,1,2024-10-15 07:18:56,4,4,8,2024-10-15 07:26:56
S1888599,2,2024-10-15 07:21:19,4,2,6,2024-10-15 07:27:19
S6101032,1,2024-10-15 07:37:31,11,23,34,2024-10-15 08:11:31
S5411948,2,2024-10-15 07:44:46,13,3,16,2024-10-15 08:00:46
S4097017,4,2024-10-15 07:47:04,12,17,29,2024-10-15 08:16:04
S1511832,5,2024-10-15 07:58:15,4,8,12,2024-10-15 08:10:15
S6493679,2,2024-10-15 08:07:22,6,4,10,2024-10-15 08:17:22
S1812888,1,2024-10-15 08:15:08,9,26,35,2024-10-15 08:50:08
S9308701,4,2024-10-15 08:16:35,8,3,11,2024-10-15 08:27:35
S7119861,2,2024-10-15 08:26:04,10,18,28,2024-10-15 08:54:04
S5151513,3,2024-10-15 08:27:06,3,7,10,2024-10-15 08:37:06
S9896432,4,2024-10-15 08:33:18,2,11,13,2024-10-15 08:46:18
S2766125,3,2024-10-15 08:48:48,6,3,9,2024-10-15 08:57:48
S4811292,1,2024-10-15 08:52:36,10,16,26,2024-10-15 09:18:36
S8643668,2,2024-10-15 08:55:20,1,1,2,2024-10-15 08:57:20
S9966505,2,2024-10-15 08:57:38,5,5,10,2024-10-15 09:07:38
S3107610,2,2024-10-15 09:11:49,2,4,6,2024-10-15 09:17:49
S4246764,3,2024-10-15 09:13:15,6,6,12,2024-10-15 09:25:15
S5159783,4,2024-10-15 09:16:06,10,26,36,2024-10-15 09:52:06
S4829629,1,2024-10-15 09:19:44,4,8,12,2024-10-15 09:31:44
S2165886,2,2024-10-15 09:29:02,12,19,31,2024-10-15 10:00:02
S8645070,1,2024-10-15 09:32:18,6,8,14,2024-10-15 09:46:18
S5386968,3,2024-10-15 09:35:30,2,13,15,2024-10-15 09:50:30
S3327051,5,2024-10-15 09:36:47,6,3,9,2024-10-15 09:45:47
S7738625,1,2024-10-15 10:00:31,3,2,5,2024-10-15 10:05:31
S4513997,1,2024-10-15 10:07:41,1,1,2,2024-10-15 10:09:41
S0113127,1,2024-10-15 10:11:51,1,8,9,2024-10-15 10:20:51
S4639973,2,2024-10-15 10:13:38,4,53,57,2024-10-15 11:10:38
S1290032,3,2024-10-15 10:15:23,12,29,41,2024-10-15 10:56:23
S9134219,1,2024-10-15 10:21:39,8,21,29,2024-10-15 10:50:39
S1634813,4,2024-10-15 10:26:15,11,25,36,2024-10-15 11:02:15
S7184843,5,2024-10-15 10:26:38,5,19,24,2024-10-15 10:50:38
S8576307,1,2024-10-15 10:54:42,6,4,10,2024-10-15 11:04:42
S3158987,1,2024-10-15 11:08:01,7,28,35,2024-10-15 11:43:01
S8269357,2,2024-10-15 11:16:36,4,4,8,2024-10-15 11:24:36
S4452398,3,2024-10-15 11:23:44,2,5,7,2024-10-15 11:30:44
S7214005,2,2024-10-15 11:33:20,8,35,43,2024-10-15 12:16:20
S4445813,3,2024-10-15 11:42:02,1,16,17,2024-10-15 11:59:02
S4895413,1,2024-10-15 11:46:59,3,100,103,2024-10-15 13:29:59
S0161974,4,2024-10-15 11:47:48,12,12,24,2024-10-15 12:11:48
S5013741,5,2024-10-15 11:56:30,7,13,20,2024-10-15 12:16:30
S4395123,3,2024-10-15 11:59:11,13,15,28,2024-10-15 12:27:11
S3374475,4,2024-10-15 12:15:44,6,41,47,2024-10-15 13:02:44
S2612979,2,2024-10-15 12:24:25,4,4,8,2024-10-15 12:32:25
S0507320,3,2024-10-15 12:29:57,1,1,2,2024-10-15 12:31:57
S8908933,2,2024-10-15 12:36:38,2,4,6,2024-10-15 12:42:38
S8470613,3,2024-10-15 12:41:59,2,29,31,2024-10-15 13:12:59
S8244890,2,2024-10-15 12:48:49,9,8,17,2024-10-15 13:05:49
S5411226,5,2024-10-15 12:51:01,7,19,26,2024-10-15 13:17:01
S1260839,4,2024-10-15 13:02:49,5,32,37,2024-10-15 13:39:49
S7836731,2,2024-10-15 13:07:42,2,8,10,2024-10-15 13:17:42
S3312521,3,2024-10-15 13:15:04,8,4,12,2024-10-15 13:27:04
S8708948,2,2024-10-15 13:19:32,10,15,25,2024-10-15 13:44:32
S5516826,5,2024-10-15 13:21:58,3,16,19,2024-10-15 13:40:58
S5454432,1,2024-10-15 13:35:33,2,10,12,2024-10-15 13:47:33
S4398071,3,2024-10-15 13:36:44,12,2,14,2024-10-15 13:50:44
S7516456,4,2024-10-15 13:42:30,1,8,9,2024-10-15 13:51:30
S3339116,2,2024-10-15 13:45:21,7,2,9,2024-10-15 13:54:21
S9052230,1,2024-10-15 14:15:49,2,49,51,2024-10-15 15:06:49
S4558296,2,2024-10-15 14:17:39,7,20,27,2024-10-15 14:44:39
S1415173,3,2024-10-15 14:25:01,3,22,25,2024-10-15 14:50:01
S7580949,4,2024-10-15 14:29:04,3,22,25,2024-10-15 14:54:04
S9221991,5,2024-10-15 14:39:02,8,9,17,2024-10-15 14:56:02
S1408175,2,2024-10-15 14:49:09,6,33,39,2024-10-15 15:28:09
S4736765,3,2024-10-15 14:50:31,3,1,4,2024-10-15 14:54:31
S8654302,3,2024-10-15 15:00:04,5,23,28,2024-10-15 15:28:04
S2103195,4,2024-10-15 15:01:45,4,3,7,2024-10-15 15:08:45
S2657339,1,2024-10-15 15:08:05,9,8,17,2024-10-15 15:25:05
S1973663,4,2024-10-15 15:12:22,4,21,25,2024-10-15 15:37:22
S6333285,1,2024-10-15 15:41:52,7,13,20,2024-10-15 16:01:52
S1426745,2,2024-10-15 15:42:10,8,5,13,2024-10-15 15:55:10
S2856655,3,2024-10-15 15:42:18,4,55,59,2024-10-15 16:41:18
S1812906,4,2024-10-15 15:51:16,2,32,34,2024-10-15 16:25:16
S6740775,2,2024-10-15 15:55:11,5,8,13,2024-10-15 16:08:11
S8690773,5,2024-10-15 16:01:51,5,2,7,2024-10-15 16:08:51
S5869959,1,2024-10-15 16:01:58,3,3,6,2024-10-15 16:07:58
S1251052,1,2024-10-15 16:08:55,2,3,5,2024-10-15 16:13:55
S7455824,2,2024-10-15 16:12:15,5,12,17,2024-10-15 16:29:15
S8740066,1,2024-10-15 16:18:23,1,1,2,2024-10-15 16:20:23
S7637957,1,2024-10-15 16:23:44,14,36,50,2024-10-15 17:13:44
S1760876,2,2024-10-15 16:35:47,1,6,7,2024-10-15 16:42:47
S4736245,2,2024-10-15 16:45:35,10,23,33,2024-10-15 17:18:35
S5740697,3,2024-10-15 16:51:45,9,5,14,2024-10-15 17:05:45
S0602857,4,2024-10-15 16:54:33,2,1,3,2024-10-15 16:57:33
S5865029,4,2024-10-15 17:01:21,6,10,16,2024-10-15 17:17:21
S4376419,5,2024-10-15 17:04:03,8,8,16,2024-10-15 17:20:03
S1699886,3,2024-10-15 17:05:49,8,36,44,2024-10-15 17:49:49
S8703460,1,2024-10-15 17:21:29,1,2,3,2024-10-15 17:24:29
S9210469,2,2024-10-15 17:22:04,3,21,24,2024-10-15 17:46:04
S5768192,4,2024-10-15 17:22:57,8,7,15,2024-10-15 17:37:57
S0271513,5,2024-10-15 17:23:12,2,4,6,2024-10-15 17:29:12
S4847138,1,2024-10-15 17:31:56,10,13,23,2024-10-15 17:54:56
S7909439,5,2024-10-15 17:33:00,7,32,39,2024-10-15 18:12:00
S2473846,4,2024-10-15 17:38:44,4,12,16,2024-10-15 17:54:44
S0922143,2,2024-10-15 17:46:11,2,9,11,2024-10-15 17:57:11
S5129912,3,2024-10-15 17:51:28,2,1,3,2024-10-15 17:54:28
S3273913,1,2024-10-15 18:20:46,3,1,4,2024-10-15 18:24:46
S5888163,2,2024-10-15 18:24:12,6,31,37,2024-10-15 19:01:12
S9945936,1,2024-10-15 18:24:46,2,3,5,2024-10-15 18:29:46
S8338223,1,2024-10-15 18:31:06,5,21,26,2024-10-15 18:57:06
S4557314,3,2024-10-15 18:38:12,3,2,5,2024-10-15 18:43:12
S1963628,4,2024-10-15 18:42:25,3,1,4,2024-10-15 18:46:25
S7790939,1,2024-10-15 19:05:52,9,20,29,2024-10-15 19:34:52
S0060008,2,2024-10-15 19:13:07,9,50,59,2024-10-15 20:12:07
S2260401,3,2024-10-15 19:24:28,8,15,23,2024-10-15 19:47:28
S2881407,1,2024-10-15 19:35:32,3,16,19,2024-10-15 19:54:32
S5224026,4,2024-10-15 19:35:57,6,4,10,2024-10-15 19:45:57
S2959639,5,2024-10-15 19:39:23,6,7,13,2024-10-15 19:52:23
S2862627,3,2024-10-15 19:47:47,5,3,8,2024-10-15 19:55:47
S1783171,4,2024-10-15 19:54:30,3,28,31,2024-10-15 20:25:30
S8500565,1,2024-10-15 19:56:02,9,9,18,2024-10-15 20:14:02
S0910417,3,2024-10-15 19:59:08,7,7,14,2024-10-15 20:13:08
S1869274,5,2024-10-15 20:04:45,2,18,20,2024-10-15 20:24:45
S9599931,1,2024-10-15 20:23:11,4,5,9,2024-10-15 20:32:11
S7734447,1,2024-10-15 20:32:49,5,2,7,2024-10-15 20:39:49
S3836884,2,2024-10-15 20:33:15,2,3,5,2024-10-15 20:38:15
S1738892,2,2024-10-15 20:39:41,2,3,5,2024-10-15 20:44:41
S3261654,1,2024-10-15 20:56:39,6,4,10,2024-10-15 21:06:39
S8258452,2,2024-10-15 20:59:01,9,4,13,2024-10-15 21:12:01
S2478616,1,2024-10-15 21:07:58,7,6,13,2024-10-15 21:20:58
S1889842,2,2024-10-15 21:13:58,6,6,12,2024-10-15 21:25:58
S9505819,3,2024-10-15 21:14:06,10,2,12,2024-10-15 21:26:06
S2651606,4,2024-10-15 21:16:48,13,9,22,2024-10-15 21:38:48
S5689237,5,2024-10-15 21:18:32,8,5,13,2024-10-15 21:31:32
S4439966,1,2024-10-15 21:22:45,5,17,22,2024-10-15 21:44:45
S3017404,2,2024-10-15 21:28:34,2,2,4,2024-10-15 21:32:34
S2289322,3,2024-10-15 21:31:05,6,21,27,2024-10-15 21:58:05
S7011707,2,2024-10-15 21:36:19,6,7,13,2024-10-15 21:49:19
S8297559,4,2024-10-15 21:43:45,7,29,36,2024-10-15 22:19:45
S4501198,1,2024-10-15 21:46:30,7,19,26,2024-10-15 22:12:30
S4962955,5,2024-10-15 21:48:54,9,9,18,2024-10-15 22:06:54
S3863311,2,2024-10-15 21:53:17,3,22,25,2024-10-15 22:18:17
S6557120,3,2024-10-15 22:07:07,3,28,31,2024-10-15 22:38:07
S6452732,5,2024-10-15 22:11:34,5,65,70,2024-10-15 23:21:34
S1602301,1,2024-10-15 22:16:46,1,2,3,2024-10-15 22:19:46
S1434608,1,2024-10-15 22:35:32,5,6,11,2024-10-15 22:46:32
S2824789,2,2024-10-15 22:42:01,2,39,41,2024-10-15 23:23:01
S5090211,1,2024-10-15 22:46:32,9,30,39,2024-10-15 23:25:32
S8067280,3,2024-10-15 22:52:28,5,11,16,2024-10-15 23:08:28
S5410609,4,2024-10-15 22:56:52,10,16,26,2024-10-15 23:22:52
S4906590,3,2024-10-15 23:09:50,5,31,36,2024-10-15 23:45:50
S7837271,5,2024-10-15 23:22:35,4,4,8,2024-10-15 23:30:35
S5970762,1,2024-10-15 23:26:57,1,88,89,2024-10-16 00:55:57
S2689355,2,2024-10-15 23:41:52,1,15,16,2024-10-15 23:57:52
S5229777,4,2024-10-15 23:44:21,3,5,8,2024-10-15 23:52:21
S3230604,5,2024-10-15 23:44:38,6,20,26,2024-10-16 00:10:38
S7788421,3,2024-10-15 23:56:08,3,84,87,2024-10-16 01:23:08
S3235551,2,2024-10-15 23:59:30,7,2,9,2024-10-16 00:08:30
S8507577,4,2024-10-16 00:02:21,8,7,15,2024-10-16 00:17:21
S0162137,2,2024-10-16 00:23:48,3,11,14,2024-10-16 00:37:48
S8264611,4,2024-10-16 00:25:49,2,9,11,2024-10-16 00:36:49
S8653370,5,2024-10-16 00:31:43,5,34,39,2024-10-16 01:10:43
S3114436,2,2024-10-16 00:39:27,12,24,36,2024-10-16 01:15:27
S6515308,4,2024-10-16 00:42:34,6,3,9,2024-10-16 00:51:34
S2946212,4,2024-10-16 00:53:35,5,6,11,2024-10-16 01:04:35
S9859611,1,2024-10-16 01:01:30,6,6,12,2024-10-16 01:13:30
S3363654,4,2024-10-16 01:06:51,11,14,25,2024-10-16 01:31:51
S1686170,1,2024-10-16 01:22:36,8,25,33,2024-10-16 01:55:36
S7091018,2,2024-10-16 01:24:32,12,3,15,2024-10-16 01:39:32
S4249047,3,2024-10-16 01:28:11,5,2,7,2024-10-16 01:35:11
S3719160,5,2024-10-16 01:31:21,5,5,10,2024-10-16 01:41:21
S0114826,2,2024-10-16 01:41:48,2,81,83,2024-10-16 03:04:48
S3936504,3,2024-10-16 01:44:58,4,2,6,2024-10-16 01:50:58
S0481225,1,2024-10-16 02:00:50,6,46,52,2024-10-16 02:52:50
S2039579,3,2024-10-16 02:06:04,8,2,10,2024-10-16 02:16:04
S5981518,3,2024-10-16 02:19:04,1,26,27,2024-10-16 02:46:04
S9619941,4,2024-10-16 02:21:22,4,2,6,2024-10-16 02:27:22
S9372873,5,2024-10-16 02:26:08,10,19,29,2024-10-16 02:55:08
S8467126,4,2024-10-16 02:33:58,8,17,25,2024-10-16 02:58:58
S5667446,3,2024-10-16 02:48:45,1,5,6,2024-10-16 02:54:45
S0466177,1,2024-10-16 02:54:36,9,8,17,2024-10-16 03:11:36
S6933299,3,2024-10-16 02:54:56,12,2,14,2024-10-16 03:08:56
S5265894,5,2024-10-16 02:55:10,12,7,19,2024-10-16 03:14:10
S8796575,4,2024-10-16 03:00:02,5,1,6,2024-10-16 03:06:02
S4075529,2,2024-10-16 03:05:54,5,19,24,2024-10-16 03:29:54
S2120772,4,2024-10-16 03:08:10,2,28,30,2024-10-16 03:38:10
S8784417,1,2024-10-16 03:17:58,7,16,23,2024-10-16 03:40:58
S4469823,3,2024-10-16 03:24:33,12,31,43,2024-10-16 04:07:33
S5486162,2,2024-10-16 03:30:01,9,9,18,2024-10-16 03:48:01
S5233425,5,2024-10-16 03:30:54,4,39,43,2024-10-16 04:13:54
S4662431,1,2024-10-16 03:44:18,13,34,47,2024-10-16 04:31:18
S2833799,2,2024-10-16 03:48:19,2,23,25,2024-10-16 04:13:19
S7911029,4,2024-10-16 03:51:26,12,47,59,2024-10-16 04:50:26
S8872814,3,2024-10-16 04:11:48,11,18,29,2024-10-16 04:40:48
S5079995,2,2024-10-16 04:21:59,7,15,22,2024-10-16 04:43:59
S8352417,5,2024-10-16 04:29:53,9,25,34,2024-10-16 05:03:53
S2355756,1,2024-10-16 04:37:27,8,26,34,2024-10-16 05:11:27
S9656321,2,2024-10-16 04:49:45,2,10,12,2024-10-16 05:01:45
S8261328,2,2024-10-16 05:02:15,1,1,2,2024-10-16 05:04:15
S7815988,2,2024-10-16 05:10:12,1,17,18,2024-10-16 05:28:12
S6601001,1,2024-10-16 05:21:05,7,55,62,2024-10-16 06:23:05
S6529790,2,2024-10-16 05:30:52,8,1,9,2024-10-16 05:39:52
S8942790,3,2024-10-16 05:35:51,5,18,23,2024-10-16 05:58:51
S7493690,4,2024-10-16 05:37:03,1,3,4,2024-10-16 05:41:03
S0803717,2,2024-10-16 05:46:57,6,9,15,2024-10-16 06:01:57
S7305428,4,2024-10-16 05:50:14,2,43,45,2024-10-16 06:35:14
S2908089,5,2024-10-16 05:54:43,10,7,17,2024-10-16 06:11:43
S9132699,2,2024-10-16 06:18:42,4,2,6,2024-10-16 06:24:42
S3113256,3,2024-10-16 06:18:48,2,22,24,2024-10-16 06:42:48
S8702577,5,2024-10-16 06:22:13,2,8,10,2024-10-16 06:32:13
S9291396,1,2024-10-16 06:26:53,3,6,9,2024-10-16 06:35:53
S8756471,1,2024-10-16 06:38:26,6,3,9,2024-10-16 06:47:26
S5668227,2,2024-10-16 06:46:34,5,24,29,2024-10-16 07:15:34
S3856468,1,2024-10-16 06:59:29,8,17,25,2024-10-16 07:24:29
S0930228,3,2024-10-16 07:06:34,12,8,20,2024-10-16 07:26:34
S2022192,2,2024-10-16 07:18:36,5,16,21,2024-10-16 07:39:36
S8274887,4,2024-10-16 07:22:27,6,13,19,2024-10-16 07:41:27
S3914257,1,2024-10-16 07:24:40,14,13,27,2024-10-16 07:51:40
S2305035,3,2024-10-16 07:30:10,3,34,37,2024-10-16 08:07:10
S9001687,5,2024-10-16 07:30:40,2,2,4,2024-10-16 07:34:40
S6686848,5,2024-10-16 07:35:06,4,38,42,2024-10-16 08:17:06
S8928007,1,2024-10-16 08:03:12,1,9,10,2024-10-16 08:13:12
S9023566,2,2024-10-16 08:04:23,2,39,41,2024-10-16 08:45:23
S4101913,3,2024-10-16 08:09:43,7,18,25,2024-10-16 08:34:43
S4072569,4,2024-10-16 08:11:21,7,9,16,2024-10-16 08:27:21
S3644258,1,2024-10-16 08:13:52,1,24,25,2024-10-16 08:38:52
S3164904,1,2024-10-16 08:53:22,9,47,56,2024-10-16 09:49:22
S4387435,2,2024-10-16 08:56:28,4,4,8,2024-10-16 09:04:28
S0985033,3,2024-10-16 09:01:17,12,21,33,2024-10-16 09:34:17
S1885694,4,2024-10-16 09:02:21,5,3,8,2024-10-16 09:10:21
S0236887,2,2024-10-16 09:12:55,13,18,31,2024-10-16 09:43:55
S2415291,4,2024-10-16 09:13:28,7,11,18,2024-10-16 09:31:28
S9923801,5,2024-10-16 09:18:25,13,29,42,2024-10-16 10:00:25
S8884891,4,2024-10-16 09:31:34,2,2,4,2024-10-16 09:35:34
S7170655,3,2024-10-16 09:42:57,4,30,34,2024-10-16 10:16:57
S9985134,2,2024-10-16 09:45:51,4,31,35,2024-10-16 10:20:51
S1733028,4,2024-10-16 09:47:01,12,32,44,2024-10-16 10:31:01
S5972908,1,2024-10-16 09:52:39,8,6,14,2024-10-16 10:06:39
S8812353,5,2024-10-16 10:02:22,8,1,9,2024-10-16 10:11:22
S2901929,1,2024-10-16 10:09:08,10,3,13,2024-10-16 10:22:08
S8944853,1,2024-10-16 10:31:56,1,71,72,2024-10-16 11:43:56
S9289668,2,2024-10-16 10:32:29,7,26,33,2024-10-16 11:05:29
S3780177,3,2024-10-16 10:39:50,6,16,22,2024-10-16 11:01:50
S1017721,2,2024-10-16 11:11:55,8,3,11,2024-10-16 11:22:55
S4698335,3,2024-10-16 11:14:31,11,17,28,2024-10-16 11:42:31
S9920399,2,2024-10-16 11:41:06,1,13,14,2024-10-16 11:55:06
S4136553,1,2024-10-16 11:47:55,7,4,11,2024-10-16 11:58:55
S3374158,3,2024-10-16 11:49:48,7,19,26,2024-10-16 12:15:48
S6573098,1,2024-10-16 12:12:36,11,3,14,2024-10-16 12:26:36
S7755623,2,2024-10-16 12:25:00,7,29,36,2024-10-16 13:01:00
S3589580,1,2024-10-16 12:26:45,6,4,10,2024-10-16 12:36:45
S1404621,3,2024-10-16 12:30:26,10,22,32,2024-10-16 13:02:26
S3288141,4,2024-10-16 12:36:11,6,20,26,2024-10-16 13:02:11
S5638272,1,2024-10-16 12:46:30,7,24,31,2024-10-16 13:17:30
S7570412,5,2024-10-16 12:52:02,1,5,6,2024-10-16 12:58:02
S6851315,5,2024-10-16 12:58:56,6,10,16,2024-10-16 13:14:56
S1444065,2,2024-10-16 13:10:30,1,10,11,2024-10-16 13:21:30
S9133576,3,2024-10-16 13:12:34,6,19,25,2024-10-16 13:37:34
S6420732,1,2024-10-16 13:17:46,10,25,35,2024-10-16 13:52:46
S0434479,4,2024-10-16 13:18:58,3,8,11,2024-10-16 13:29:58
S4367623,5,2024-10-16 13:20:20,7,3,10,2024-10-16 13:30:20
S9748814,2,2024-10-16 13:23:47,6,28,34,2024-10-16 13:57:47
S5996789,4,2024-10-16 13:36:14,5,63,68,2024-10-16 14:44:14
S7384630,5,2024-10-16 13:37:27,5,6,11,2024-10-16 13:48:27
S2886181,1,2024-10-16 14:02:02,7,9,16,2024-10-16 14:18:02
S0366612,2,2024-10-16 14:05:51,3,11,14,2024-10-16 14:19:51
S9114368,3,2024-10-16 14:13:56,2,36,38,2024-10-16 14:51:56
S0786582,5,2024-10-16 14:14:22,1,62,63,2024-10-16 15:17:22
S1218762,1,2024-10-16 14:19:07,6,11,17,2024-10-16 14:36:07
S9087075,2,2024-10-16 14:27:32,5,67,72,2024-10-16 15:39:32
S3253931,1,2024-10-16 14:39:21,10,18,28,2024-10-16 15:07:21
S3185598,4,2024-10-16 14:51:42,10,2,12,2024-10-16 15:03:42
S6586967,3,2024-10-16 15:01:37,7,2,9,2024-10-16 15:10:37
S4657480,4,2024-10-16 15:05:32,5,14,19,2024-10-16 15:24:32
S1105576,1,2024-10-16 15:08:53,3,1,4,2024-10-16 15:12:53
S4153303,3,2024-10-16 15:11:21,2,18,20,2024-10-16 15:31:21
S4401299,1,2024-10-16 15:28:04,10,15,25,2024-10-16 15:53:04
S9741650,3,2024-10-16 15:32:29,1,57,58,2024-10-16 16:30:29
S0938587,4,2024-10-16 15:32:55,6,12,18,2024-10-16 15:50:55
S3155439,2,2024-10-16 15:39:43,8,4,12,2024-10-16 15:51:43
S0535847,1,2024-10-16 16:07:47,2,52,54,2024-10-16 17:01:47
S8435395,2,2024-10-16 16:11:31,7,21,28,2024-10-16 16:39:31
S3875875,4,2024-10-16 16:13:19,2,1,3,2024-10-16 16:16:19
S3203123,5,2024-10-16 16:16:17,10,1,11,2024-10-16 16:27:17
S6417339,4,2024-10-16 16:20:32,3,7,10,2024-10-16 16:30:32
S9926633,5,2024-10-16 16:29:36,7,29,36,2024-10-16 17:05:36
S9333145,3,2024-10-16 16:32:27,9,9,18,2024-10-16 16:50:27
S1341415,4,2024-10-16 16:37:08,3,11,14,2024-10-16 16:51:08
S5742889,2,2024-10-16 16:42:37,3,9,12,2024-10-16 16:54:37
S8945537,2,2024-10-16 16:59:52,4,5,9,2024-10-16 17:08:52
S9833937,1,2024-10-16 17:10:05,7,27,34,2024-10-16 17:44:05
S4744097,2,2024-10-16 17:13:23,6,5,11,2024-10-16 17:24:23
S1059548,3,2024-10-16 17:17:10,3,1,4,2024-10-16 17:21:10
S6819973,2,2024-10-16 17:31:19,10,36,46,2024-10-16 18:17:19
S8462689,3,2024-10-16 17:40:23,5,1,6,2024-10-16 17:46:23
S0963912,4,2024-10-16 17:41:43,1,7,8,2024-10-16 17:49:43
S7492857,5,2024-10-16 17:42:55,2,66,68,2024-10-16 18:50:55
S4268196,1,2024-10-16 17:51:51,7,7,14,2024-10-16 18:05:51
S1647411,3,2024-10-16 17:54:45,1,6,7,2024-10-16 18:01:45
S8384184,4,2024-10-16 17:54:57,10,9,19,2024-10-16 18:13:57
S2363232,1,2024-10-16 18:08:29,3,4,7,2024-10-16 18:15:29
S4724308,1,2024-10-16 18:23:05,5,5,10,2024-10-16 18:33:05
S7436394,1,2024-10-16 18:38:55,6,18,24,2024-10-16 19:02:55
S8204792,2,2024-10-16 18:52:17,6,2,8,2024-10-16 19:00:17
S6456953,3,2024-10-16 18:54:16,8,9,17,2024-10-16 19:11:16
S8537638,4,2024-10-16 18:56:40,4,1,5,2024-10-16 19:01:40
S3771530,5,2024-10-16 18:57:26,5,12,17,2024-10-16 19:14:26
S2412653,2,2024-10-16 19:01:14,1,4,5,2024-10-16 19:06:14
S9338249,1,2024-10-16 19:05:22,6,3,9,2024-10-16 19:14:22
S3887254,2,2024-10-16 19:08:40,5,13,18,2024-10-16 19:26:40
S5024195,1,2024-10-16 19:38:27,7,3,10,2024-10-16 19:48:27
S8636197,2,2024-10-16 19:44:29,2,5,7,2024-10-16 19:51:29
S3618201,3,2024-10-16 19:47:41,1,39,40,2024-10-16 20:27:41
S7036101,1,2024-10-16 19:49:44,4,2,6,2024-10-16 19:55:44
S8648054,2,2024-10-16 19:52:29,4,68,72,2024-10-16 21:04:29
S6719319,4,2024-10-16 19:55:29,5,23,28,2024-10-16 20:23:29
S2955631,1,2024-10-16 19:56:16,10,5,15,2024-10-16 20:11:16
S9385946,5,2024-10-16 20:00:11,5,2,7,2024-10-16 20:07:11
S9803242,1,2024-10-16 20:19:07,3,9,12,2024-10-16 20:31:07
S9477217,1,2024-10-16 20:31:35,1,2,3,2024-10-16 20:34:35
S3976371,1,2024-10-16 20:45:05,1,23,24,2024-10-16 21:09:05
S7003727,3,2024-10-16 20:46:52,11,46,57,2024-10-16 21:43:52
S8678934,4,2024-10-16 20:48:25,1,1,2,2024-10-16 20:50:25
S7021656,5,2024-10-16 20:49:41,4,9,13,2024-10-16 21:02:41
S5977983,4,2024-10-16 21:02:46,3,13,16,2024-10-16 21:18:46
S3390498,2,2024-10-16 21:08:40,4,32,36,2024-10-16 21:44:40
S9940842,1,2024-10-16 21:12:30,10,8,18,2024-10-16 21:30:30
S9583208,4,2024-10-16 21:30:29,6,45,51,2024-10-16 22:21:29
S6982315,1,2024-10-16 21:36:57,8,3,11,2024-10-16 21:47:57
S6626112,5,2024-10-16 21:40:27,15,30,45,2024-10-16 22:25:27
S1257595,2,2024-10-16 21:46:48,3,31,34,2024-10-16 22:20:48
S3042925,1,2024-10-16 21:55:41,8,11,19,2024-10-16 22:14:41
S2646690,3,2024-10-16 21:58:44,8,6,14,2024-10-16 22:12:44
S4089201,1,2024-10-16 22:17:29,1,10,11,2024-10-16 22:28:29
S4025069,3,2024-10-16 22:17:48,8,9,17,2024-10-16 22:34:48
S5798235,2,2024-10-16 22:23:54,11,15,26,2024-10-16 22:49:54
S1699392,4,2024-10-16 22:28:15,6,35,41,2024-10-16 23:09:15
S4731095,1,2024-10-16 22:28:43,3,8,11,2024-10-16 22:39:43
S1457474,5,2024-10-16 22:31:45,5,9,14,2024-10-16 22:45:45
S9430876,1,2024-10-16 22:42:10,2,6,8,2024-10-16 22:50:10
S6399670,3,2024-10-16 22:44:15,3,6,9,2024-10-16 22:53:15
S7586314,2,2024-10-16 22:49:55,5,4,9,2024-10-16 22:58:55
S7837607,1,2024-10-16 22:56:38,1,6,7,2024-10-16 23:03:38
S7460782,2,2024-10-16 23:02:40,1,13,14,2024-10-16 23:16:40
S3905513,1,2024-10-16 23:04:11,7,36,43,2024-10-16 23:47:11
S6282094,3,2024-10-16 23:10:29,2,22,24,2024-10-16 23:34:29
S9085737,2,2024-10-16 23:19:31,2,31,33,2024-10-16 23:52:31
S6821321,4,2024-10-16 23:22:37,3,50,53,2024-10-17 00:15:37
S1995707,3,2024-10-16 23:36:14,6,5,11,2024-10-16 23:47:14
S4806780,5,2024-10-16 23:38:41,7,2,9,2024-10-16 23:47:41
S9633242,1,2024-10-16 23:48:14,5,7,12,2024-10-17 00:00:14
S1949671,3,2024-10-16 23:52:08,2,24,26,2024-10-17 00:18:08
S1595249,1,2024-10-17 00:04:28,7,2,9,2024-10-17 00:13:28
S5167316,2,2024-10-17 00:05:44,2,130,132,2024-10-17 02:17:44
S2650419,1,2024-10-17 00:18:07,1,4,5,2024-10-17 00:23:07
S6340424,3,2024-10-17 00:21:37,4,6,10,2024-10-17 00:31:37
S3451351,1,2024-10-17 00:35:44,2,1,3,2024-10-17 00:38:44
S2244275,1,2024-10-17 00:43:33,5,5,10,2024-10-17 00:53:33
S2613475,3,2024-10-17 00:50:06,2,9,11,2024-10-17 01:01:06
S7561145,4,2024-10-17 00:50:23,1,20,21,2024-10-17 01:11:23
S7185782,5,2024-10-17 00:50:41,12,16,28,2024-10-17 01:18:41
S2067256,1,2024-10-17 00:54:06,13,42,55,2024-10-17 01:49:06
S4571038,3,2024-10-17 01:07:40,7,5,12,2024-10-17 01:19:40
S3919543,4,2024-10-17 01:14:44,8,2,10,2024-10-17 01:24:44
S2792162,3,2024-10-17 01:20:00,1,3,4,2024-10-17 01:24:00
S1430091,3,2024-10-17 01:36:33,8,3,11,2024-10-17 01:47:33
S3033498,4,2024-10-17 01:36:46,3,3,6,2024-10-17 01:42:46
S5299813,5,2024-10-17 01:41:46,4,3,7,2024-10-17 01:48:46
S8806761,1,2024-10-17 01:50:36,3,74,77,2024-10-17 03:07:36
S5227239,3,2024-10-17 01:51:11,5,5,10,2024-10-17 02:01:11
S5750498,4,2024-10-17 01:53:05,4,58,62,2024-10-17 02:55:05
S6245153,5,2024-10-17 01:54:26,3,4,7,2024-10-17 02:01:26
S0895952,3,2024-10-17 02:04:11,7,6,13,2024-10-17 02:17:11
S4708846,5,2024-10-17 02:08:28,7,15,22,2024-10-17 02:30:28
S6902989,3,2024-10-17 02:17:39,3,2,5,2024-10-17 02:22:39
S8966268,2,2024-10-17 02:18:37,1,15,16,2024-10-17 02:34:37
S2095763,3,2024-10-17 02:28:25,4,5,9,2024-10-17 02:37:25
S5988025,2,2024-10-17 02:45:53,10,22,32,2024-10-17 03:17:53
S0254542,3,2024-10-17 02:53:27,5,6,11,2024-10-17 03:04:27
S3705853,4,2024-10-17 02:55:18,8,6,14,2024-10-17 03:09:18
S2464558,3,2024-10-17 03:05:44,7,15,22,2024-10-17 03:27:44
S0987032,5,2024-10-17 03:07:28,2,35,37,2024-10-17 03:44:28
S8592767,1,2024-10-17 03:42:53,8,36,44,2024-10-17 04:26:53
S2476923,2,2024-10-17 03:47:49,3,25,28,2024-10-17 04:15:49
S2907911,3,2024-10-17 03:47:54,12,50,62,2024-10-17 04:49:54
S7559891,4,2024-10-17 03:48:17,1,4,5,2024-10-17 03:53:17
S0998028,4,2024-10-17 04:03:08,3,19,22,2024-10-17 04:25:08
S1873763,5,2024-10-17 04:06:43,10,13,23,2024-10-17 04:29:43
S9134665,2,2024-10-17 04:17:00,7,17,24,2024-10-17 04:41:00
S9510680,1,2024-10-17 04:35:07,2,12,14,2024-10-17 04:49:07
S6398617,4,2024-10-17 04:36:14,6,33,39,2024-10-17 05:15:14
S0312474,5,2024-10-17 04:37:28,2,32,34,2024-10-17 05:11:28
S1680267,2,2024-10-17 04:42:55,11,95,106,2024-10-17 06:28:55
S7070406,1,2024-10-17 04:54:55,6,3,9,2024-10-17 05:03:55
S9890755,1,2024-10-17 05:08:11,3,3,6,2024-10-17 05:14:11
S1828140,3,2024-10-17 05:10:17,7,7,14,2024-10-17 05:24:17
S0813815,1,2024-10-17 05:26:23,5,1,6,2024-10-17 05:32:23
S2947774,3,2024-10-17 05:30:39,12,13,25,2024-10-17 05:55:39
S7773165,1,2024-10-17 05:33:45,9,2,11,2024-10-17 05:44:45
S7407143,4,2024-10-17 05:34:47,4,22,26,2024-10-17 06:00:47
S0163078,1,2024-10-17 05:45:06,2,2,4,2024-10-17 05:49:06
S2023161,5,2024-10-17 05:46:02,4,51,55,2024-10-17 06:41:02
S7797304,1,2024-10-17 05:50:11,5,9,14,2024-10-17 06:04:11
S2741905,3,2024-10-17 05:58:28,1,9,10,2024-10-17 06:08:28
S1275298,4,2024-10-17 06:03:18,10,43,53,2024-10-17 06:56:18
S2199269,1,2024-10-17 06:08:56,11,7,18,2024-10-17 06:26:56
S3764783,3,2024-10-17 06:14:02,2,12,14,2024-10-17 06:28:02
S0698849,1,2024-10-17 06:46:42,12,13,25,2024-10-17 07:11:42
S3455964,2,2024-10-17 06:55:32,3,17,20,2024-10-17 07:15:32
S5980181,3,2024-10-17 07:03:56,12,8,20,2024-10-17 07:23:56
S2783181,4,2024-10-17 07:06:13,7,18,25,2024-10-17 07:31:13
S8320593,5,2024-10-17 07:09:01,4,73,77,2024-10-17 08:26:01
S4876504,1,2024-10-17 07:16:58,4,4,8,2024-10-17 07:24:58
S1626418,2,2024-10-17 07:21:06,4,21,25,2024-10-17 07:46:06
S2279177,1,2024-10-17 07:28:32,2,1,3,2024-10-17 07:31:32
S8765769,3,2024-10-17 07:29:43,3,16,19,2024-10-17 07:48:43
S5355368,1,2024-10-17 07:36:17,4,29,33,2024-10-17 08:09:17
S7854745,4,2024-10-17 07:40:48,8,35,43,2024-10-17 08:23:48
S1858547,2,2024-10-17 07:59:19,10,6,16,2024-10-17 08:15:19
S4722037,3,2024-10-17 08:03:18,2,1,3,2024-10-17 08:06:18
S9272381,1,2024-10-17 08:17:57,6,1,7,2024-10-17 08:24:57
S6021188,1,2024-10-17 08:27:55,8,3,11,2024-10-17 08:38:55
S5701697,2,2024-10-17 08:31:15,8,19,27,2024-10-17 08:58:15
S7122696,3,2024-10-17 08:33:02,10,65,75,2024-10-17 09:48:02
S8784664,4,2024-10-17 08:33:24,3,48,51,2024-10-17 09:24:24
S5065571,5,2024-10-17 08:34:42,3,6,9,2024-10-17 08:43:42
S2598592,1,2024-10-17 08:46:35,3,17,20,2024-10-17 09:06:35
S3656333,5,2024-10-17 08:46:49,3,5,8,2024-10-17 08:54:49
S2046033,2,2024-10-17 09:05:06,12,10,22,2024-10-17 09:27:06
S7799203,1,2024-10-17 09:17:21,10,13,23,2024-10-17 09:40:21
S7539417,4,2024-10-17 09:25:42,13,44,57,2024-10-17 10:22:42
S3179413,2,2024-10-17 09:29:16,3,3,6,2024-10-17 09:35:16
S3291982,5,2024-10-17 09:34:17,6,14,20,2024-10-17 09:54:17
S9243715,2,2024-10-17 09:36:48,12,9,21,2024-10-17 09:57:48
S2147177,1,2024-10-17 09:41:51,2,1,3,2024-10-17 09:44:51
S5939033,1,2024-10-17 09:45:33,2,7,9,2024-10-17 09:54:33
S6496489,3,2024-10-17 09:51:52,3,39,42,2024-10-17 10:33:52
S8959125,1,2024-10-17 10:06:37,8,6,14,2024-10-17 10:20:37
S2178653,2,2024-10-17 10:06:55,6,2,8,2024-10-17 10:14:55
S3790345,1,2024-10-17 10:23:52,3,1,4,2024-10-17 10:27:52
S9830097,1,2024-10-17 10:33:44,5,12,17,2024-10-17 10:50:44
S0184682,2,2024-10-17 10:36:11,5,2,7,2024-10-17 10:43:11
S4627698,3,2024-10-17 10:40:25,4,4,8,2024-10-17 10:48:25
S7087435,4,2024-10-17 10:42:23,5,36,41,2024-10-17 11:23:23
S7493642,1,2024-10-17 10:54:37,12,26,38,2024-10-17 11:32:37
S9122225,2,2024-10-17 10:59:04,5,13,18,2024-10-17 11:17:04
S1321168,3,2024-10-17 11:03:07,6,15,21,2024-10-17 11:24:07
S9873349,5,2024-10-17 11:04:19,1,1,2,2024-10-17 11:06:19
S2815542,5,2024-10-17 11:13:42,1,12,13,2024-10-17 11:26:42
S0178669,2,2024-10-17 11:25:10,6,4,10,2024-10-17 11:35:10
S6062261,3,2024-10-17 11:27:43,3,71,74,2024-10-17 12:41:43
S2714550,4,2024-10-17 11:29:06,3,16,19,2024-10-17 11:48:06
S6267210,1,2024-10-17 11:33:05,5,8,13,2024-10-17 11:46:05
S2472199,5,2024-10-17 11:33:34,3,3,6,2024-10-17 11:39:34
S2929615,2,2024-10-17 11:40:03,12,30,42,2024-10-17 12:22:03
S6916042,1,2024-10-17 11:59:15,1,1,2,2024-10-17 12:01:15
S9048275,4,2024-10-17 11:59:35,10,14,24,2024-10-17 12:23:35
S4470141,1,2024-10-17 12:01:23,9,2,11,2024-10-17 12:12:23
S7591642,5,2024-10-17 12:02:52,5,2,7,2024-10-17 12:09:52
S4096055,5,2024-10-17 12:10:10,6,25,31,2024-10-17 12:41:10
S3806059,1,2024-10-17 12:13:20,9,69,78,2024-10-17 13:31:20
S5749765,2,2024-10-17 12:36:10,2,31,33,2024-10-17 13:09:10
S7529152,4,2024-10-17 12:38:00,6,9,15,2024-10-17 12:53:00
S9288680,5,2024-10-17 12:41:21,6,4,10,2024-10-17 12:51:21
S0708507,3,2024-10-17 12:41:56,5,11,16,2024-10-17 12:57:56
S8676298,4,2024-10-17 12:57:46,3,30,33,2024-10-17 13:30:46
S9910531,3,2024-10-17 12:59:15,1,17,18,2024-10-17 13:17:15
S4148857,5,2024-10-17 13:04:25,9,16,25,2024-10-17 13:29:25
S0676746,2,2024-10-17 13:11:43,5,9,14,2024-10-17 13:25:43
S9656621,2,2024-10-17 13:28:06,8,37,45,2024-10-17 14:13:06
S0802572,1,2024-10-17 13:37:41,3,14,17,2024-10-17 13:54:41
S6941366,3,2024-10-17 13:38:12,9,11,20,2024-10-17 13:58:12
S8864839,4,2024-10-17 13:39:20,7,4,11,2024-10-17 13:50:20
S1608106,5,2024-10-17 13:41:28,10,24,34,2024-10-17 14:15:28
S4587085,1,2024-10-17 13:57:57,7,11,18,2024-10-17 14:15:57
S3041456,3,2024-10-17 13:59:58,10,17,27,2024-10-17 14:26:58
S8310294,4,2024-10-17 14:07:47,12,40,52,2024-10-17 14:59:47
S1013345,1,2024-10-17 14:20:28,3,7,10,2024-10-17 14:30:28
S6414044,2,2024-10-17 14:21:07,6,18,24,2024-10-17 14:45:07
S7125390,3,2024-10-17 14:30:23,3,16,19,2024-10-17 14:49:23
S2071566,1,2024-10-17 14:35:05,4,2,6,2024-10-17 14:41:05
S2747293,5,2024-10-17 14:38:28,3,13,16,2024-10-17 14:54:28
S6243441,1,2024-10-17 14:43:25,6,2,8,2024-10-17 14:51:25
S6958225,2,2024-10-17 14:46:52,5,11,16,2024-10-17 15:02:52
S8844073,1,2024-10-17 15:00:04,9,47,56,2024-10-17 15:56:04
S1020461,2,2024-10-17 15:11:49,4,22,26,2024-10-17 15:37:49
S1820006,3,2024-10-17 15:12:24,4,5,9,2024-10-17 15:21:24
S9969571,4,2024-10-17 15:12:43,9,9,18,2024-10-17 15:30:43
S2164360,5,2024-10-17 15:16:55,8,35,43,2024-10-17 15:59:55
S9580709,3,2024-10-17 15:22:43,5,21,26,2024-10-17 15:48:43
S2375718,2,2024-10-17 15:50:36,4,2,6,2024-10-17 15:56:36
S1003667,3,2024-10-17 15:52:14,8,2,10,2024-10-17 16:02:14
S1466024,1,2024-10-17 16:23:17,6,9,15,2024-10-17 16:38:17
S8941140,2,2024-10-17 16:24:08,6,6,12,2024-10-17 16:36:08
S8831549,3,2024-10-17 16:35:15,2,4,6,2024-10-17 16:41:15
S9698822,1,2024-10-17 16:43:54,5,35,40,2024-10-17 17:23:54
S9369588,2,2024-10-17 16:46:44,8,1,9,2024-10-17 16:55:44
S6803096,3,2024-10-17 16:54:49,6,21,27,2024-10-17 17:21:49
S6730455,2,2024-10-17 17:09:27,3,1,4,2024-10-17 17:13:27
S9595952,4,2024-10-17 17:09:50,10,25,35,2024-10-17 17:44:50
S6366386,5,2024-10-17 17:11:06,4,14,18,2024-10-17 17:29:06
S9728073,2,2024-10-17 17:13:58,4,6,10,2024-10-17 17:23:58
S3775817,1,2024-10-17 17:23:54,7,2,9,2024-10-17 17:32:54
S0176938,1,2024-10-17 17:33:21,2,1,3,2024-10-17 17:36:21
S6369291,2,2024-10-17 17:35:49,6,5,11,2024-10-17 17:46:49
S4052142,3,2024-10-17 17:36:05,3,22,25,2024-10-17 18:01:05
S7053655,1,2024-10-17 17:36:42,16,7,23,2024-10-17 17:59:42
S7413879,5,2024-10-17 17:39:05,4,10,14,2024-10-17 17:53:05
S8882745,4,2024-10-17 17:46:41,6,9,15,2024-10-17 18:01:41
S7553140,2,2024-10-17 17:48:26,3,3,6,2024-10-17 17:54:26
S3637579,1,2024-10-17 18:08:18,2,1,3,2024-10-17 18:11:18
S0602899,1,2024-10-17 18:24:49,2,29,31,2024-10-17 18:55:49
S0499666,2,2024-10-17 18:29:10,4,3,7,2024-10-17 18:36:10
S6761879,3,2024-10-17 18:32:31,4,16,20,2024-10-17 18:52:31
S8393665,2,2024-10-17 18:49:10,1,15,16,2024-10-17 19:05:10
S5006551,4,2024-10-17 18:49:41,7,6,13,2024-10-17 19:02:41
S1371924,1,2024-10-17 19:18:29,10,69,79,2024-10-17 20:37:29
S0096210,2,2024-10-17 19:23:12,3,1,4,2024-10-17 19:27:12
S0486760,3,2024-10-17 19:24:07,8,4,12,2024-10-17 19:36:07
S0882621,2,2024-10-17 19:30:58,7,6,13,2024-10-17 19:43:58
S0260500,2,2024-10-17 19:49:26,5,55,60,2024-10-17 20:49:26
S4097616,3,2024-10-17 20:00:25,9,32,41,2024-10-17 20:41:25
S3799082,4,2024-10-17 20:04:02,9,8,17,2024-10-17 20:21:02
S0406398,5,2024-10-17 20:05:36,2,78,80,2024-10-17 21:25:36
S7246652,4,2024-10-17 20:25:15,3,2,5,2024-10-17 20:30:15
S2043675,4,2024-10-17 20:35:08,2,1,3,2024-10-17 20:38:08
S5810569,1,2024-10-17 20:38:07,3,13,16,2024-10-17 20:54:07
S2841517,3,2024-10-17 20:46:40,10,10,20,2024-10-17 21:06:40
S2964498,4,2024-10-17 20:49:08,4,2,6,2024-10-17 20:55:08
S1290773,1,2024-10-17 20:55:10,7,4,11,2024-10-17 21:06:10
S7443483,2,2024-10-17 20:55:26,9,56,65,2024-10-17 22:00:26
S1172953,4,2024-10-17 21:02:53,9,24,33,2024-10-17 21:35:53
S5912540,1,2024-10-17 21:08:03,7,9,16,2024-10-17 21:24:03
S3621131,3,2024-10-17 21:08:34,2,45,47,2024-10-17 21:55:34
S1509595,1,2024-10-17 21:28:52,12,41,53,2024-10-17 22:21:52
S6374312,4,2024-10-17 21:41:46,9,24,33,2024-10-17 22:14:46
S2988430,5,2024-10-17 21:43:34,1,8,9,2024-10-17 21:52:34
S9028191,2,2024-10-17 22:01:10,3,11,14,2024-10-17 22:15:10
S7496489,3,2024-10-17 22:12:59,4,10,14,2024-10-17 22:26:59
S8146344,2,2024-10-17 22:20:09,5,19,24,2024-10-17 22:44:09
S0682698,4,2024-10-17 22:20:58,2,2,4,2024-10-17 22:24:58
S3586649,1,2024-10-17 22:28:20,6,13,19,2024-10-17 22:47:20
S4981927,3,2024-10-17 22:28:42,8,30,38,2024-10-17 23:06:42
S9116925,4,2024-10-17 22:32:06,12,9,21,2024-10-17 22:53:06
S5159566,5,2024-10-17 22:40:48,3,19,22,2024-10-17 23:02:48
S9937639,1,2024-10-17 22:54:46,11,17,28,2024-10-17 23:22:46
S3419445,2,2024-10-17 22:56:16,11,17,28,2024-10-17 23:24:16
S2711992,4,2024-10-17 23:01:04,4,10,14,2024-10-17 23:15:04
S6523949,3,2024-10-17 23:16:04,7,9,16,2024-10-17 23:32:04
S5865327,4,2024-10-17 23:16:04,4,12,16,2024-10-17 23:32:04
S3010419,5,2024-10-17 23:16:04,13,21,34,2024-10-17 23:50:04
S3052781,1,2024-10-17 23:31:04,7,14,21,2024-10-17 23:52:04
S9516099,2,2024-10-17 23:31:04,3,8,11,2024-10-17 23:42:04
S4730338,2,2024-10-17 23:46:04,5,1,6,2024-10-17 23:52:04
S0578728,3,2024-10-17 23:46:04,6,8,14,2024-10-18 00:00:04
S2637686,4,2024-10-17 23:46:04,4,4,8,2024-10-17 23:54:04
S5782732,1,2024-10-18 00:01:04,2,27,29,2024-10-18 00:30:04
S2741653,2,2024-10-18 00:01:04,2,7,9,2024-10-18 00:10:04
S4179870,3,2024-10-18 00:01:04,4,43,47,2024-10-18 00:48:04
S6873410,4,2024-10-18 00:01:04,10,3,13,2024-10-18 00:14:04
S7034345,5,2024-10-18 00:01:04,3,3,6,2024-10-18 00:07:04
S9257882,2,2024-10-18 00:16:04,8,5,13,2024-10-18 00:29:04
S9063212,4,2024-10-18 00:16:04,12,34,46,2024-10-18 01:02:04
S9580330,5,2024-10-18 00:16:04,1,1,2,2024-10-18 00:18:04
S9881965,1,2024-10-18 00:31:04,4,60,64,2024-10-18 01:35:04
S0925066,2,2024-10-18 00:31:04,11,11,22,2024-10-18 00:53:04
S5891667,5,2024-10-18 00:31:04,4,2,6,2024-10-18 00:37:04
S7662282,5,2024-10-18 00:46:04,7,28,35,2024-10-18 01:21:04
S4092268,2,2024-10-18 01:01:04,7,31,38,2024-10-18 01:39:04
S3188581,3,2024-10-18 01:01:04,7,1,8,2024-10-18 01:09:04
S9978817,3,2024-10-18 01:16:04,6,8,14,2024-10-18 01:30:04
S0919631,4,2024-10-18 01:16:04,9,3,12,2024-10-18 01:28:04
S8039158,3,2024-10-18 01:31:04,18,32,50,2024-10-18 02:21:04
S5858822,4,2024-10-18 01:31:04,6,36,42,2024-10-18 02:13:04
S6452899,5,2024-10-18 01:31:04,7,21,28,2024-10-18 01:59:04
S8573689,1,2024-10-18 01:46:04,6,8,14,2024-10-18 02:00:04
S7833285,2,2024-10-18 01:46:04,9,20,29,2024-10-18 02:15:04
S3624027,1,2024-10-18 02:01:04,3,36,39,2024-10-18 02:40:04
S4173461,5,2024-10-18 02:01:04,4,1,5,2024-10-18 02:06:04
S4724773,2,2024-10-18 02:16:04,8,3,11,2024-10-18 02:27:04
S8555968,4,2024-10-18 02:16:04,4,28,32,2024-10-18 02:48:04
S0533734,5,2024-10-18 02:16:04,5,14,19,2024-10-18 02:35:04
S0578452,2,2024-10-18 02:31:04,2,45,47,2024-10-18 03:18:04
S1350986,3,2024-10-18 02:31:04,6,8,14,2024-10-18 02:45:04
S7151712,1,2024-10-18 02:46:04,5,10,15,2024-10-18 03:01:04
S3376628,3,2024-10-18 02:46:04,1,37,38,2024-10-18 03:24:04
S2016485,5,2024-10-18 02:46:04,2,2,4,2024-10-18 02:50:04
S7014310,1,2024-10-18 03:01:04,5,6,11,2024-10-18 03:12:04
S6974562,4,2024-10-18 03:01:04,6,39,45,2024-10-18 03:46:04
S3087678,5,2024-10-18 03:01:04,12,39,51,2024-10-18 03:52:04
S2574728,1,2024-10-18 03:16:04,3,13,16,2024-10-18 03:32:04
S6539365,2,2024-10-18 03:31:04,2,1,3,2024-10-18 03:34:04
S4443264,3,2024-10-18 03:31:04,5,46,51,2024-10-18 04:22:04
S7217380,1,2024-10-18 03:46:04,11,10,21,2024-10-18 04:07:04
S6334451,2,2024-10-18 03:46:04,1,14,15,2024-10-18 04:01:04
S1710170,4,2024-10-18 03:46:04,4,27,31,2024-10-18 04:17:04
S0829905,2,2024-10-18 04:01:04,5,18,23,2024-10-18 04:24:04
S3474950,5,2024-10-18 04:01:04,5,6,11,2024-10-18 04:12:04
S8613447,1,2024-10-18 04:16:04,2,1,3,2024-10-18 04:19:04
S9947288,5,2024-10-18 04:16:04,1,34,35,2024-10-18 04:51:04
S0216777,1,2024-10-18 04:31:04,3,16,19,2024-10-18 04:50:04
S6785184,2,2024-10-18 04:31:04,5,17,22,2024-10-18 04:53:04
S7263890,3,2024-10-18 04:31:04,6,49,55,2024-10-18 05:26:04
S4798053,4,2024-10-18 04:31:04,8,14,22,2024-10-18 04:53:04
S4250599,1,2024-10-18 05:01:04,6,3,9,2024-10-18 05:10:04
S6841402,2,2024-10-18 05:01:04,1,3,4,2024-10-18 05:05:04
S7111525,4,2024-10-18 05:01:04,3,11,14,2024-10-18 05:15:04
S2106574,5,2024-10-18 05:01:04,7,25,32,2024-10-18 05:33:04
S6913773,1,2024-10-18 05:16:04,2,1,3,2024-10-18 05:19:04
S3642844,2,2024-10-18 05:16:04,2,28,30,2024-10-18 05:46:04
S9770803,4,2024-10-18 05:16:04,3,11,14,2024-10-18 05:30:04
S3631101,1,2024-10-18 05:31:04,6,20,26,2024-10-18 05:57:04
S7421758,3,2024-10-18 05:31:04,11,21,32,2024-10-18 06:03:04
S1748205,4,2024-10-18 05:31:04,2,2,4,2024-10-18 05:35:04
S5700922,2,2024-10-18 05:46:04,4,9,13,2024-10-18 05:59:04
S1827595,4,2024-10-18 05:46:04,11,31,42,2024-10-18 06:28:04
S1682518,5,2024-10-18 05:46:04,1,4,5,2024-10-18 05:51:04
S2075769,1,2024-10-18 06:01:04,6,42,48,2024-10-18 06:49:04
S8601535,2,2024-10-18 06:01:04,1,2,3,2024-10-18 06:04:04
S5680730,5,2024-10-18 06:01:04,4,5,9,2024-10-18 06:10:04
S8260500,2,2024-10-18 06:16:04,2,1,3,2024-10-18 06:19:04
S0338696,3,2024-10-18 06:16:04,5,8,13,2024-10-18 06:29:04
S2680677,5,2024-10-18 06:16:04,8,23,31,2024-10-18 06:47:04
S5020082,2,2024-10-18 06:31:04,1,25,26,2024-10-18 06:57:04
S2313366,3,2024-10-18 06:31:04,8,13,21,2024-10-18 06:52:04
S1378227,4,2024-10-18 06:31:04,7,14,21,2024-10-18 06:52:04
S5644959,1,2024-10-18 07:01:04,3,2,5,2024-10-18 07:06:04
S9499073,2,2024-10-18 07:01:04,4,28,32,2024-10-18 07:33:04
S0523748,3,2024-10-18 07:01:04,9,1,10,2024-10-18 07:11:04
S5770045,4,2024-10-18 07:01:04,4,13,17,2024-10-18 07:18:04
S2805574,5,2024-10-18 07:01:04,1,1,2,2024-10-18 07:03:04
S9910747,1,2024-10-18 07:16:04,10,38,48,2024-10-18 08:04:04
S3317783,3,2024-10-18 07:16:04,3,57,60,2024-10-18 08:16:04
S8853227,5,2024-10-18 07:16:04,8,59,67,2024-10-18 08:23:04
S0372129,4,2024-10-18 07:31:04,7,3,10,2024-10-18 07:41:04
S1424808,2,2024-10-18 07:46:04,1,14,15,2024-10-18 08:01:04
S4009278,4,2024-10-18 07:46:04,9,11,20,2024-10-18 08:06:04
S1216463,2,2024-10-18 08:01:04,2,4,6,2024-10-18 08:07:04
S3440055,1,2024-10-18 08:16:04,6,83,89,2024-10-18 09:45:04
S6002770,2,2024-10-18 08:16:04,3,3,6,2024-10-18 08:22:04
S7105941,3,2024-10-18 08:16:04,3,4,7,2024-10-18 08:23:04
S1217988,4,2024-10-18 08:16:04,5,44,49,2024-10-18 09:05:04
S3248492,2,2024-10-18 08:31:04,7,45,52,2024-10-18 09:23:04
S1736351,3,2024-10-18 08:31:04,5,12,17,2024-10-18 08:48:04
S4443942,5,2024-10-18 08:31:04,7,67,74,2024-10-18 09:45:04
S6813723,3,2024-10-18 09:01:04,7,5,12,2024-10-18 09:13:04
S7451902,3,2024-10-18 09:16:04,5,11,16,2024-10-18 09:32:04
S0924050,4,2024-10-18 09:16:04,1,17,18,2024-10-18 09:34:04
S8888717,2,2024-10-18 09:31:04,3,10,13,2024-10-18 09:44:04
S4904140,1,2024-10-18 09:46:04,7,5,12,2024-10-18 09:58:04
S7600101,2,2024-10-18 09:46:04,5,4,9,2024-10-18 09:55:04
S2115217,3,2024-10-18 09:46:04,1,18,19,2024-10-18 10:05:04
S9976887,4,2024-10-18 09:46:04,2,3,5,2024-10-18 09:51:04
S5104814,5,2024-10-18 09:46:04,5,9,14,2024-10-18 10:00:04
S5750880,1,2024-10-18 10:01:04,2,62,64,2024-10-18 11:05:04
S8369109,2,2024-10-18 10:01:04,9,14,23,2024-10-18 10:24:04
S5257259,4,2024-10-18 10:01:04,10,7,17,2024-10-18 10:18:04
S8480157,5,2024-10-18 10:01:04,9,78,87,2024-10-18 11:28:04
S6820018,3,2024-10-18 10:16:04,3,3,6,2024-10-18 10:22:04
S2831257,2,2024-10-18 10:31:04,2,5,7,2024-10-18 10:38:04
S1624015,3,2024-10-18 10:31:04,4,49,53,2024-10-18 11:24:04
S3025993,4,2024-10-18 10:31:04,5,9,14,2024-10-18 10:45:04
S2061104,2,2024-10-18 10:46:04,10,34,44,2024-10-18 11:30:04
S5427927,4,2024-10-18 10:46:04,7,4,11,2024-10-18 10:57:04
S5505373,4,2024-10-18 11:01:04,8,24,32,2024-10-18 11:33:04
S3672238,1,2024-10-18 11:16:04,5,10,15,2024-10-18 11:31:04
S3152697,1,2024-10-18 11:31:04,5,46,51,2024-10-18 12:22:04
S3275275,2,2024-10-18 11:31:04,8,7,15,2024-10-18 11:46:04
S4940424,3,2024-10-18 11:31:04,6,9,15,2024-10-18 11:46:04
S2679885,5,2024-10-18 11:31:04,3,24,27,2024-10-18 11:58:04
S8686916,2,2024-10-18 11:46:04,6,2,8,2024-10-18 11:54:04
S7961246,3,2024-10-18 11:46:04,2,9,11,2024-10-18 11:57:04
S6155599,4,2024-10-18 11:46:04,1,12,13,2024-10-18 11:59:04
S7385273,2,2024-10-18 12:01:04,14,21,35,2024-10-18 12:36:04
S0946720,3,2024-10-18 12:01:04,7,14,21,2024-10-18 12:22:04
S1605742,4,2024-10-18 12:01:04,3,21,24,2024-10-18 12:25:04
S9593439,5,2024-10-18 12:01:04,3,2,5,2024-10-18 12:06:04
S0646196,5,2024-10-18 12:16:04,2,17,19,2024-10-18 12:35:04
S4044561,1,2024-10-18 12:31:04,11,2,13,2024-10-18 12:44:04
S5063480,3,2024-10-18 12:31:04,5,5,10,2024-10-18 12:41:04
S2672485,4,2024-10-18 12:31:04,3,27,30,2024-10-18 13:01:04
S9476560,1,2024-10-18 12:46:04,5,4,9,2024-10-18 12:55:04
S3289146,2,2024-10-18 12:46:04,5,8,13,2024-10-18 12:59:04
S9656139,3,2024-10-18 12:46:04,4,2,6,2024-10-18 12:52:04
S0604620,5,2024-10-18 12:46:04,6,21,27,2024-10-18 13:13:04
S4738357,1,2024-10-18 13:01:04,1,3,4,2024-10-18 13:05:04
S4599926,2,2024-10-18 13:01:04,4,18,22,2024-10-18 13:23:04
S0830750,3,2024-10-18 13:01:04,7,14,21,2024-10-18 13:22:04
S3495588,4,2024-10-18 13:01:04,5,30,35,2024-10-18 13:36:04
S6789411,1,2024-10-18 13:16:04,6,32,38,2024-10-18 13:54:04
S9952578,5,2024-10-18 13:16:04,5,12,17,2024-10-18 13:33:04
S9600232,2,2024-10-18 13:31:04,2,19,21,2024-10-18 13:52:04
S2535207,3,2024-10-18 13:31:04,1,1,2,2024-10-18 13:33:04
S9255104,3,2024-10-18 13:46:04,9,24,33,2024-10-18 14:19:04
S0815668,4,2024-10-18 13:46:04,9,17,26,2024-10-18 14:12:04
S9162666,5,2024-10-18 13:46:04,5,34,39,2024-10-18 14:25:04
S8376468,1,2024-10-18 14:01:04,13,20,33,2024-10-18 14:34:04
S4422030,2,2024-10-18 14:01:04,1,37,38,2024-10-18 14:39:04
S1817881,4,2024-10-18 14:16:04,2,3,5,2024-10-18 14:21:04
S0224263,3,2024-10-18 14:31:04,9,10,19,2024-10-18 14:50:04
S3893805,4,2024-10-18 14:31:04,4,2,6,2024-10-18 14:37:04
S4085070,5,2024-10-18 14:31:04,12,12,24,2024-10-18 14:55:04
S1926288,1,2024-10-18 14:46:04,5,18,23,2024-10-18 15:09:04
S4165878,2,2024-10-18 14:46:04,3,1,4,2024-10-18 14:50:04
S1408239,4,2024-10-18 14:46:04,2,17,19,2024-10-18 15:05:04
S7527511,2,2024-10-18 15:01:04,11,38,49,2024-10-18 15:50:04
S4495462,3,2024-10-18 15:01:04,6,26,32,2024-10-18 15:33:04
S7761362,5,2024-10-18 15:01:04,6,8,14,2024-10-18 15:15:04
S5427351,1,2024-10-18 15:16:04,10,9,19,2024-10-18 15:35:04
S6704338,4,2024-10-18 15:16:04,6,8,14,2024-10-18 15:30:04
S8406286,5,2024-10-18 15:16:04,1,8,9,2024-10-18 15:25:04
S5214281,4,2024-10-18 15:31:04,10,17,27,2024-10-18 15:58:04
S3071561,5,2024-10-18 15:31:04,8,22,30,2024-10-18 16:01:04
