ship_id,berth,arrival_time,containers_dropped_off,containers_loaded,operation_time,departure_time
S3542705,1,2024-10-13 19:01:04,4,8,12,2024-10-13 19:13:04
S7834667,2,2024-10-13 19:04:46,9,23,32,2024-10-13 19:36:46
S7891383,3,2024-10-13 19:09:14,3,23,26,2024-10-13 19:35:14
S8225602,4,2024-10-13 19:12:33,1,1,2,2024-10-13 19:14:33
S2148011,1,2024-10-13 19:17:25,9,80,89,2024-10-13 20:46:25
S4921232,4,2024-10-13 19:29:54,3,17,20,2024-10-13 19:49:54
S3867679,5,2024-10-13 19:33:52,4,22,26,2024-10-13 19:59:52
S3362550,2,2024-10-13 19:46:58,2,6,8,2024-10-13 19:54:58
S9970044,3,2024-10-13 19:47:24,4,4,8,2024-10-13 19:55:24
S3942463,2,2024-10-13 19:55:11,11,6,17,2024-10-13 20:12:11
S2711992,3,2024-10-13 19:56:00,7,3,10,2024-10-13 20:06:00
S4324690,4,2024-10-13 20:03:58,6,2,8,2024-10-13 20:11:58
S8617514,3,2024-10-13 20:10:16,8,7,15,2024-10-13 20:25:16
S7242845,2,2024-10-13 20:13:14,8,4,12,2024-10-13 20:25:14
S7146229,4,2024-10-13 20:17:01,1,11,12,2024-10-13 20:29:01
S8178303,5,2024-10-13 20:20:24,1,10,11,2024-10-13 20:31:24
S5639940,2,2024-10-13 20:30:41,4,27,31,2024-10-13 21:01:41
S1800547,3,2024-10-13 20:31:04,2,13,15,2024-10-13 20:46:04
S6523949,4,2024-10-13 20:32:34,8,1,9,2024-10-13 20:41:34
S8246338,5,2024-10-13 20:36:42,6,66,72,2024-10-13 21:48:42
S1265479,4,2024-10-13 20:42:15,12,42,54,2024-10-13 21:36:15
S3052781,1,2024-10-13 20:48:39,5,10,15,2024-10-13 21:03:39
S9516099,3,2024-10-13 20:56:23,7,13,20,2024-10-13 21:16:23
S2901623,1,2024-10-13 21:20:49,3,54,57,2024-10-13 22:17:49
S8776777,2,2024-10-13 21:22:09,4,4,8,2024-10-13 21:30:09
S4062619,3,2024-10-13 21:27:06,3,7,10,2024-10-13 21:37:06
S1738638,2,2024-10-13 21:32:46,2,5,7,2024-10-13 21:39:46
S3841447,2,2024-10-13 21:40:39,7,66,73,2024-10-13 22:53:39
S6945217,3,2024-10-13 21:42:10,6,7,13,2024-10-13 21:55:10
S5902180,4,2024-10-13 21:47:03,4,34,38,2024-10-13 22:25:03
S4730338,5,2024-10-13 21:50:26,5,24,29,2024-10-13 22:19:26
S6986626,3,2024-10-13 22:04:57,7,2,9,2024-10-13 22:13:57
S5422961,1,2024-10-13 22:26:03,7,31,38,2024-10-13 23:04:03
S8176405,3,2024-10-13 22:27:43,8,9,17,2024-10-13 22:44:43
S5747319,4,2024-10-13 22:30:32,10,9,19,2024-10-13 22:49:32
S7200769,5,2024-10-13 22:42:21,1,41,42,2024-10-13 23:24:21
S1782701,3,2024-10-13 22:49:56,2,11,13,2024-10-13 23:02:56
S2211843,2,2024-10-13 22:56:26,10,5,15,2024-10-13 23:11:26
S8348947,1,2024-10-13 23:07:56,4,10,14,2024-10-13 23:21:56
S0096604,3,2024-10-13 23:08:17,2,14,16,2024-10-13 23:24:17
S5782732,4,2024-10-13 23:11:21,3,44,47,2024-10-13 23:58:21
S3744721,2,2024-10-13 23:13:20,1,54,55,2024-10-14 00:08:20
S1436472,1,2024-10-13 23:23:06,14,22,36,2024-10-13 23:59:06
S9778486,3,2024-10-13 23:27:07,5,58,63,2024-10-14 00:30:07
S1647502,5,2024-10-13 23:27:27,4,8,12,2024-10-13 23:39:27
S4103669,5,2024-10-13 23:43:18,7,1,8,2024-10-13 23:51:18
S3514693,5,2024-10-13 23:56:12,6,11,17,2024-10-14 00:13:12
S6414930,1,2024-10-14 00:05:44,1,6,7,2024-10-14 00:12:44
S6724649,1,2024-10-14 00:27:29,8,11,19,2024-10-14 00:46:29
S0636259,2,2024-10-14 00:30:44,1,18,19,2024-10-14 00:49:44
S9573316,3,2024-10-14 00:31:55,4,33,37,2024-10-14 01:08:55
S1945625,4,2024-10-14 00:35:33,2,12,14,2024-10-14 00:49:33
S8268078,5,2024-10-14 00:36:45,9,23,32,2024-10-14 01:08:45
S2556044,1,2024-10-14 00:47:51,7,7,14,2024-10-14 01:01:51
S3070649,2,2024-10-14 00:54:09,2,5,7,2024-10-14 01:01:09
S6913821,1,2024-10-14 01:03:14,4,30,34,2024-10-14 01:37:14
S0789679,2,2024-10-14 01:10:17,13,29,42,2024-10-14 01:52:17
S6566465,3,2024-10-14 01:17:09,6,22,28,2024-10-14 01:45:09
S2818827,4,2024-10-14 01:18:07,2,11,13,2024-10-14 01:31:07
S2092982,5,2024-10-14 01:18:21,7,12,19,2024-10-14 01:37:21
S7424136,1,2024-10-14 01:41:31,11,18,29,2024-10-14 02:10:31
S1011118,3,2024-10-14 01:46:24,8,7,15,2024-10-14 02:01:24
S7561136,4,2024-10-14 01:48:09,7,7,14,2024-10-14 02:02:09
S3075211,2,2024-10-14 01:55:53,9,18,27,2024-10-14 02:22:53
S1244395,5,2024-10-14 01:58:34,5,3,8,2024-10-14 02:06:34
S1650324,1,2024-10-14 02:15:46,6,40,46,2024-10-14 03:01:46
S6841098,3,2024-10-14 02:20:58,1,33,34,2024-10-14 02:54:58
S4247981,2,2024-10-14 02:26:42,1,3,4,2024-10-14 02:30:42
S6570666,4,2024-10-14 02:27:42,2,2,4,2024-10-14 02:31:42
S9851054,2,2024-10-14 02:33:55,6,4,10,2024-10-14 02:43:55
S9731172,4,2024-10-14 02:41:49,7,2,9,2024-10-14 02:50:49
S4370361,5,2024-10-14 02:42:08,9,17,26,2024-10-14 03:08:08
S0824560,2,2024-10-14 02:44:28,3,15,18,2024-10-14 03:02:28
S3011171,3,2024-10-14 03:01:25,8,9,17,2024-10-14 03:18:25
S6288533,1,2024-10-14 03:03:28,6,65,71,2024-10-14 04:14:28
S5247188,2,2024-10-14 03:12:24,14,23,37,2024-10-14 03:49:24
S9741739,4,2024-10-14 03:16:01,7,5,12,2024-10-14 03:28:01
S7637121,3,2024-10-14 03:19:42,13,25,38,2024-10-14 03:57:42
S4061701,5,2024-10-14 03:25:56,10,45,55,2024-10-14 04:20:56
S0779971,4,2024-10-14 03:35:15,4,43,47,2024-10-14 04:22:15
S7662282,2,2024-10-14 03:51:48,3,19,22,2024-10-14 04:13:48
S4388708,3,2024-10-14 03:58:52,2,40,42,2024-10-14 04:40:52
S3188581,2,2024-10-14 04:14:14,7,5,12,2024-10-14 04:26:14
S9978817,1,2024-10-14 04:26:33,4,11,15,2024-10-14 04:41:33
S1912906,2,2024-10-14 04:29:32,14,13,27,2024-10-14 04:56:32
S3248442,4,2024-10-14 04:34:48,2,36,38,2024-10-14 05:12:48
S7700000,3,2024-10-14 04:41:03,1,8,9,2024-10-14 04:50:03
S1448246,1,2024-10-14 04:42:09,7,5,12,2024-10-14 04:54:09
S8707502,5,2024-10-14 04:46:40,5,6,11,2024-10-14 04:57:40
S7152461,3,2024-10-14 04:53:39,3,8,11,2024-10-14 05:04:39
S5863576,1,2024-10-14 05:02:12,2,29,31,2024-10-14 05:33:12
S2905179,2,2024-10-14 05:07:11,5,22,27,2024-10-14 05:34:11
S7827330,3,2024-10-14 05:17:21,8,26,34,2024-10-14 05:51:21
S0919631,4,2024-10-14 05:18:52,3,4,7,2024-10-14 05:25:52
S8039158,4,2024-10-14 05:28:14,2,14,16,2024-10-14 05:44:14
S0034549,1,2024-10-14 05:36:48,4,38,42,2024-10-14 06:18:48
S0231774,2,2024-10-14 05:53:05,2,9,11,2024-10-14 06:04:05
S1966951,3,2024-10-14 05:54:29,11,11,22,2024-10-14 06:16:29
S1828325,4,2024-10-14 05:55:36,1,49,50,2024-10-14 06:45:36
S6874752,5,2024-10-14 05:57:02,3,27,30,2024-10-14 06:27:02
S7882586,2,2024-10-14 06:10:41,5,4,9,2024-10-14 06:19:41
S9073647,1,2024-10-14 06:21:01,8,8,16,2024-10-14 06:37:01
S6849210,2,2024-10-14 06:21:04,6,26,32,2024-10-14 06:53:04
S9864531,3,2024-10-14 06:24:18,12,11,23,2024-10-14 06:47:18
S8792216,5,2024-10-14 06:28:57,11,2,13,2024-10-14 06:41:57
S8799574,1,2024-10-14 06:40:02,11,6,17,2024-10-14 06:57:02
S0555302,3,2024-10-14 06:52:59,10,10,20,2024-10-14 07:12:59
S1322271,2,2024-10-14 06:55:01,4,4,8,2024-10-14 07:03:01
S2918557,4,2024-10-14 06:55:27,4,3,7,2024-10-14 07:02:27
S1494964,1,2024-10-14 07:04:22,1,1,2,2024-10-14 07:06:22
S3839341,2,2024-10-14 07:06:05,8,18,26,2024-10-14 07:32:05
S1474699,1,2024-10-14 07:07:12,5,33,38,2024-10-14 07:45:12
S5595809,4,2024-10-14 07:10:45,2,1,3,2024-10-14 07:13:45
S5858822,5,2024-10-14 07:11:00,7,23,30,2024-10-14 07:41:00
S8573689,3,2024-10-14 07:15:46,12,13,25,2024-10-14 07:40:46
S7280156,4,2024-10-14 07:18:12,8,15,23,2024-10-14 07:41:12
S7833285,2,2024-10-14 07:33:27,3,7,10,2024-10-14 07:43:27
S0464247,1,2024-10-14 07:47:10,8,32,40,2024-10-14 08:27:10
S5946862,2,2024-10-14 07:55:13,5,24,29,2024-10-14 08:24:13
S5877968,3,2024-10-14 08:03:16,2,29,31,2024-10-14 08:34:16
S5013638,4,2024-10-14 08:10:44,5,8,13,2024-10-14 08:23:44
S2462256,5,2024-10-14 08:12:42,8,9,17,2024-10-14 08:29:42
S8168934,2,2024-10-14 08:25:55,7,19,26,2024-10-14 08:51:55
S9277595,1,2024-10-14 08:28:54,11,18,29,2024-10-14 08:57:54
S7378135,4,2024-10-14 08:33:46,5,5,10,2024-10-14 08:43:46
S6065898,3,2024-10-14 08:43:23,7,1,8,2024-10-14 08:51:23
S3324915,4,2024-10-14 08:44:39,4,6,10,2024-10-14 08:54:39
S2916217,3,2024-10-14 08:51:35,7,1,8,2024-10-14 08:59:35
S2745558,2,2024-10-14 08:57:03,2,27,29,2024-10-14 09:26:03
S6216970,1,2024-10-14 09:04:39,7,9,16,2024-10-14 09:20:39
S4321159,3,2024-10-14 09:07:27,3,72,75,2024-10-14 10:22:27
S5680988,4,2024-10-14 09:18:26,7,64,71,2024-10-14 10:29:26
S5898666,5,2024-10-14 09:18:57,4,38,42,2024-10-14 10:00:57
S4469912,1,2024-10-14 09:22:03,16,23,39,2024-10-14 10:01:03
S0871144,2,2024-10-14 09:30:36,3,13,16,2024-10-14 09:46:36
S6791969,2,2024-10-14 09:50:35,2,8,10,2024-10-14 10:00:35
S0011749,1,2024-10-14 10:07:10,2,5,7,2024-10-14 10:14:10
S2351560,1,2024-10-14 10:22:27,1,6,7,2024-10-14 10:29:27
S2086571,1,2024-10-14 10:39:55,8,2,10,2024-10-14 10:49:55
S8963260,2,2024-10-14 10:43:08,9,6,15,2024-10-14 10:58:08
S3671970,1,2024-10-14 10:51:16,2,12,14,2024-10-14 11:05:16
S0275016,1,2024-10-14 11:16:55,19,16,35,2024-10-14 11:51:55
S3293399,2,2024-10-14 11:23:39,4,1,5,2024-10-14 11:28:39
S8469843,2,2024-10-14 11:37:50,5,40,45,2024-10-14 12:22:50
S4983438,3,2024-10-14 11:45:29,2,1,3,2024-10-14 11:48:29
S3308339,1,2024-10-14 11:58:08,8,25,33,2024-10-14 12:31:08
S3198623,3,2024-10-14 12:01:40,4,10,14,2024-10-14 12:15:40
S9941565,4,2024-10-14 12:02:54,3,6,9,2024-10-14 12:11:54
S3333977,3,2024-10-14 12:22:15,1,5,6,2024-10-14 12:28:15
S7725676,2,2024-10-14 12:25:46,2,4,6,2024-10-14 12:31:46
S5620583,4,2024-10-14 12:26:28,2,33,35,2024-10-14 13:01:28
S8639707,5,2024-10-14 12:26:48,7,47,54,2024-10-14 13:20:48
S0482897,3,2024-10-14 12:30:22,8,8,16,2024-10-14 12:46:22
S1350986,1,2024-10-14 12:31:55,7,5,12,2024-10-14 12:43:55
S7151712,2,2024-10-14 12:32:01,8,41,49,2024-10-14 13:21:01
S7507516,1,2024-10-14 12:48:22,1,1,2,2024-10-14 12:50:22
S3862095,1,2024-10-14 12:53:46,3,12,15,2024-10-14 13:08:46
S1581242,3,2024-10-14 13:03:36,6,8,14,2024-10-14 13:17:36
S0473101,1,2024-10-14 13:10:26,4,9,13,2024-10-14 13:23:26
S8957687,2,2024-10-14 13:21:28,5,14,19,2024-10-14 13:40:28
S1170974,1,2024-10-14 13:25:55,5,3,8,2024-10-14 13:33:55
S0557218,3,2024-10-14 13:33:16,8,23,31,2024-10-14 14:04:16
S8576500,1,2024-10-14 13:49:28,5,4,9,2024-10-14 13:58:28
S7747105,2,2024-10-14 13:50:51,13,9,22,2024-10-14 14:12:51
S7168381,4,2024-10-14 13:55:50,4,7,11,2024-10-14 14:06:50
S7954335,5,2024-10-14 13:56:40,7,16,23,2024-10-14 14:19:40
S9996163,1,2024-10-14 14:00:43,1,1,2,2024-10-14 14:02:43
S2332549,1,2024-10-14 14:06:33,8,14,22,2024-10-14 14:28:33
S7014310,3,2024-10-14 14:08:02,4,1,5,2024-10-14 14:13:02
S7948302,2,2024-10-14 14:16:27,2,25,27,2024-10-14 14:43:27
S7599242,3,2024-10-14 14:20:22,7,5,12,2024-10-14 14:32:22
S7640643,4,2024-10-14 14:24:57,2,12,14,2024-10-14 14:38:57
S2020543,1,2024-10-14 14:38:24,3,1,4,2024-10-14 14:42:24
S3432460,1,2024-10-14 14:50:11,5,8,13,2024-10-14 15:03:11
S9350075,2,2024-10-14 14:56:44,5,9,14,2024-10-14 15:10:44
S2266735,3,2024-10-14 14:57:15,1,16,17,2024-10-14 15:14:15
S8059592,1,2024-10-14 15:11:10,14,18,32,2024-10-14 15:43:10
S5730020,2,2024-10-14 15:17:51,2,25,27,2024-10-14 15:44:51
S9733887,1,2024-10-14 15:49:07,2,6,8,2024-10-14 15:57:07
S0656025,2,2024-10-14 15:54:07,3,40,43,2024-10-14 16:37:07
S4842817,1,2024-10-14 15:58:00,8,10,18,2024-10-14 16:16:00
S0297693,3,2024-10-14 16:09:30,8,4,12,2024-10-14 16:21:30
S3823107,4,2024-10-14 16:09:56,10,5,15,2024-10-14 16:24:56
S4818967,1,2024-10-14 16:21:24,7,43,50,2024-10-14 17:11:24
S9463387,3,2024-10-14 16:35:45,1,49,50,2024-10-14 17:25:45
S1704945,2,2024-10-14 16:44:30,4,5,9,2024-10-14 16:53:30
S5707042,4,2024-10-14 16:45:09,8,2,10,2024-10-14 16:55:09
S0764643,5,2024-10-14 16:46:41,11,10,21,2024-10-14 17:07:41
S5803586,2,2024-10-14 16:57:54,11,42,53,2024-10-14 17:50:54
S9363425,4,2024-10-14 17:04:12,6,24,30,2024-10-14 17:34:12
S7555942,1,2024-10-14 17:12:08,8,45,53,2024-10-14 18:05:08
S2033603,5,2024-10-14 17:17:52,4,8,12,2024-10-14 17:29:52
S9163413,3,2024-10-14 17:25:53,9,9,18,2024-10-14 17:43:53
S9735723,5,2024-10-14 17:32:05,2,3,5,2024-10-14 17:37:05
S9296752,4,2024-10-14 17:34:30,6,11,17,2024-10-14 17:51:30
S4758608,2,2024-10-14 17:58:08,6,11,17,2024-10-14 18:15:08
S4680823,3,2024-10-14 18:03:47,6,26,32,2024-10-14 18:35:47
S1623473,1,2024-10-14 18:09:03,7,18,25,2024-10-14 18:34:03
S6651423,4,2024-10-14 18:10:19,8,5,13,2024-10-14 18:23:19
S2702917,1,2024-10-14 18:39:23,1,1,2,2024-10-14 18:41:23
S5385343,2,2024-10-14 18:40:40,5,3,8,2024-10-14 18:48:40
S9933470,1,2024-10-14 18:54:38,5,3,8,2024-10-14 19:02:38
S4590541,2,2024-10-14 18:59:49,4,16,20,2024-10-14 19:19:49
S6903557,1,2024-10-14 19:02:44,3,27,30,2024-10-14 19:32:44
S7215856,3,2024-10-14 19:07:39,12,32,44,2024-10-14 19:51:39
S7069566,4,2024-10-14 19:14:22,3,1,4,2024-10-14 19:18:22
S1215671,5,2024-10-14 19:17:38,5,24,29,2024-10-14 19:46:38
S8150641,2,2024-10-14 19:19:58,5,25,30,2024-10-14 19:49:58
S3087678,4,2024-10-14 19:20:01,12,37,49,2024-10-14 20:09:01
S6099432,1,2024-10-14 19:36:08,6,21,27,2024-10-14 20:03:08
S3216616,2,2024-10-14 19:55:43,2,7,9,2024-10-14 20:04:43
S8331583,1,2024-10-14 20:20:53,6,5,11,2024-10-14 20:31:53
S0733723,2,2024-10-14 20:23:18,1,13,14,2024-10-14 20:37:18
S9280351,3,2024-10-14 20:23:49,3,34,37,2024-10-14 21:00:49
S3858292,4,2024-10-14 20:24:39,5,9,14,2024-10-14 20:38:39
S8884328,1,2024-10-14 20:35:33,4,18,22,2024-10-14 20:57:33
S6571967,2,2024-10-14 20:43:06,9,5,14,2024-10-14 20:57:06
S5954879,4,2024-10-14 20:50:13,3,12,15,2024-10-14 21:05:13
S0424868,5,2024-10-14 20:56:40,11,25,36,2024-10-14 21:32:40
S2225247,1,2024-10-14 21:02:41,3,38,41,2024-10-14 21:43:41
S8604452,2,2024-10-14 21:08:21,1,2,3,2024-10-14 21:11:21
S7062896,2,2024-10-14 21:24:16,7,23,30,2024-10-14 21:54:16
S7230166,3,2024-10-14 21:33:30,13,121,134,2024-10-14 23:47:30
S4915242,4,2024-10-14 21:38:22,4,58,62,2024-10-14 22:40:22
S4267787,5,2024-10-14 21:40:10,9,38,47,2024-10-14 22:27:10
S2565748,1,2024-10-14 21:47:47,15,3,18,2024-10-14 22:05:47
S0026954,1,2024-10-14 22:24:15,8,3,11,2024-10-14 22:35:15
S5675467,2,2024-10-14 22:31:24,2,1,3,2024-10-14 22:34:24
S2318451,2,2024-10-14 22:34:25,6,3,9,2024-10-14 22:43:25
S3772250,1,2024-10-14 22:38:58,1,36,37,2024-10-14 23:15:58
S3158752,2,2024-10-14 22:59:16,2,2,4,2024-10-14 23:03:16
S8792973,4,2024-10-14 23:00:48,13,1,14,2024-10-14 23:14:48
S5188408,1,2024-10-14 23:21:09,6,4,10,2024-10-14 23:31:09
S6347729,2,2024-10-14 23:22:59,3,7,10,2024-10-14 23:32:59
S2230529,1,2024-10-14 23:36:43,7,29,36,2024-10-15 00:12:43
S5430913,2,2024-10-14 23:41:40,2,19,21,2024-10-15 00:02:40
S3417770,3,2024-10-14 23:51:28,1,1,2,2024-10-14 23:53:28
S0512939,3,2024-10-14 23:56:23,3,90,93,2024-10-15 01:29:23
S7035242,4,2024-10-15 00:00:48,7,6,13,2024-10-15 00:13:48
S3653314,2,2024-10-15 00:09:49,16,61,77,2024-10-15 01:26:49
S5099295,1,2024-10-15 00:17:47,6,43,49,2024-10-15 01:06:47
S2112005,4,2024-10-15 00:27:40,7,4,11,2024-10-15 00:38:40
S1193381,5,2024-10-15 00:31:13,9,3,12,2024-10-15 00:43:13
S4443264,4,2024-10-15 00:39:23,2,25,27,2024-10-15 01:06:23
S7217380,5,2024-10-15 00:49:31,2,3,5,2024-10-15 00:54:31
S0695031,1,2024-10-15 01:07:44,5,31,36,2024-10-15 01:43:44
S3728367,4,2024-10-15 01:09:09,3,8,11,2024-10-15 01:20:09
S5187049,5,2024-10-15 01:11:42,5,8,13,2024-10-15 01:24:42
S2852079,4,2024-10-15 01:23:37,7,25,32,2024-10-15 01:55:37
S0735556,2,2024-10-15 01:42:30,3,6,9,2024-10-15 01:51:30
S4618932,1,2024-10-15 01:47:26,11,41,52,2024-10-15 02:39:26
S1085322,3,2024-10-15 01:50:42,10,40,50,2024-10-15 02:40:42
S4033263,2,2024-10-15 02:07:27,9,10,19,2024-10-15 02:26:27
S1025895,4,2024-10-15 02:08:24,6,4,10,2024-10-15 02:18:24
S5681698,5,2024-10-15 02:11:20,3,6,9,2024-10-15 02:20:20
S0338736,2,2024-10-15 02:27:54,5,18,23,2024-10-15 02:50:54
S1754755,4,2024-10-15 02:28:03,4,14,18,2024-10-15 02:46:03
S4980064,1,2024-10-15 02:54:10,5,24,29,2024-10-15 03:23:10
S2727112,2,2024-10-15 03:01:24,4,1,5,2024-10-15 03:06:24
S9136537,2,2024-10-15 03:12:22,2,13,15,2024-10-15 03:27:22
S8463237,3,2024-10-15 03:20:58,1,17,18,2024-10-15 03:38:58
S5798616,1,2024-10-15 03:32:31,2,19,21,2024-10-15 03:53:31
S9789064,2,2024-10-15 03:39:45,7,1,8,2024-10-15 03:47:45
S1606185,3,2024-10-15 03:40:00,6,1,7,2024-10-15 03:47:00
S8326275,4,2024-10-15 03:40:23,10,9,19,2024-10-15 03:59:23
S5216197,5,2024-10-15 03:41:02,1,14,15,2024-10-15 03:56:02
S5516503,2,2024-10-15 03:51:10,6,6,12,2024-10-15 04:03:10
S8656129,3,2024-10-15 03:52:11,4,4,8,2024-10-15 04:00:11
S8613447,1,2024-10-15 03:56:54,6,6,12,2024-10-15 04:08:54
S5207712,2,2024-10-15 04:03:51,7,19,26,2024-10-15 04:29:51
S3689541,3,2024-10-15 04:05:55,5,5,10,2024-10-15 04:15:55
S2490487,1,2024-10-15 04:22:51,13,60,73,2024-10-15 05:35:51
S6409776,2,2024-10-15 04:38:34,9,3,12,2024-10-15 04:50:34
S8208156,2,2024-10-15 04:50:47,7,44,51,2024-10-15 05:41:47
S0941130,3,2024-10-15 04:56:26,1,8,9,2024-10-15 05:05:26
S9186781,3,2024-10-15 05:09:04,5,17,22,2024-10-15 05:31:04
S1735119,4,2024-10-15 05:13:41,7,2,9,2024-10-15 05:22:41
S9947288,5,2024-10-15 05:17:40,9,2,11,2024-10-15 05:28:40
S0216777,4,2024-10-15 05:25:40,2,3,5,2024-10-15 05:30:40
S0438315,1,2024-10-15 05:45:04,5,71,76,2024-10-15 07:01:04
S7895802,2,2024-10-15 05:45:22,7,19,26,2024-10-15 06:11:22
S5862249,3,2024-10-15 05:57:56,6,9,15,2024-10-15 06:12:56
S0773481,4,2024-10-15 06:09:54,5,50,55,2024-10-15 07:04:54
S8178842,2,2024-10-15 06:23:15,13,1,14,2024-10-15 06:37:15
S6933005,3,2024-10-15 06:36:16,7,14,21,2024-10-15 06:57:16
S5169957,2,2024-10-15 06:46:57,5,16,21,2024-10-15 07:07:57
S4765747,5,2024-10-15 06:47:53,11,9,20,2024-10-15 07:07:53
S8929139,1,2024-10-15 07:06:22,6,18,24,2024-10-15 07:30:22
S7263890,2,2024-10-15 07:09:47,4,11,15,2024-10-15 07:24:47
S4798053,3,2024-10-15 07:11:46,1,11,12,2024-10-15 07:23:46
S7964502,4,2024-10-15 07:18:56,10,12,22,2024-10-15 07:40:56
S1888599,5,2024-10-15 07:21:19,4,4,8,2024-10-15 07:29:19
S6101032,1,2024-10-15 07:37:31,3,10,13,2024-10-15 07:50:31
S5411948,2,2024-10-15 07:44:46,7,9,16,2024-10-15 08:00:46
S4097017,3,2024-10-15 07:47:04,3,45,48,2024-10-15 08:35:04
S1511832,1,2024-10-15 07:58:15,5,17,22,2024-10-15 08:20:15
S6493679,2,2024-10-15 08:07:22,4,2,6,2024-10-15 08:13:22
S1812888,2,2024-10-15 08:15:08,10,4,14,2024-10-15 08:29:08
S9308701,4,2024-10-15 08:16:35,4,10,14,2024-10-15 08:30:35
S7119861,1,2024-10-15 08:26:04,4,29,33,2024-10-15 08:59:04
S5151513,5,2024-10-15 08:27:06,5,3,8,2024-10-15 08:35:06
S9896432,2,2024-10-15 08:33:18,5,1,6,2024-10-15 08:39:18
S2766125,2,2024-10-15 08:48:48,3,4,7,2024-10-15 08:55:48
S4811292,3,2024-10-15 08:52:36,6,40,46,2024-10-15 09:38:36
S8643668,4,2024-10-15 08:55:20,5,3,8,2024-10-15 09:03:20
S9966505,2,2024-10-15 08:57:38,2,1,3,2024-10-15 09:00:38
S3107610,1,2024-10-15 09:11:49,3,4,7,2024-10-15 09:18:49
S4246764,2,2024-10-15 09:13:15,2,1,3,2024-10-15 09:16:15
S5159783,4,2024-10-15 09:16:06,4,5,9,2024-10-15 09:25:06
S4829629,1,2024-10-15 09:19:44,5,13,18,2024-10-15 09:37:44
S2165886,2,2024-10-15 09:29:02,6,5,11,2024-10-15 09:40:02
S8645070,4,2024-10-15 09:32:18,2,52,54,2024-10-15 10:26:18
S5386968,5,2024-10-15 09:35:30,8,15,23,2024-10-15 09:58:30
S7738625,1,2024-10-15 10:00:31,3,2,5,2024-10-15 10:05:31
S4513997,1,2024-10-15 10:07:41,3,3,6,2024-10-15 10:13:41
S0113127,2,2024-10-15 10:11:51,2,18,20,2024-10-15 10:31:51
S4639973,3,2024-10-15 10:13:38,11,20,31,2024-10-15 10:44:38
S1290032,1,2024-10-15 10:15:23,1,16,17,2024-10-15 10:32:23
S9134219,5,2024-10-15 10:21:39,2,6,8,2024-10-15 10:29:39
S7184843,4,2024-10-15 10:26:38,6,12,18,2024-10-15 10:44:38
S6841402,1,2024-10-15 10:40:55,4,5,9,2024-10-15 10:49:55
S7111525,2,2024-10-15 10:47:24,10,9,19,2024-10-15 11:06:24
S8576307,1,2024-10-15 10:54:42,2,13,15,2024-10-15 11:09:42
S3158987,2,2024-10-15 11:08:01,8,53,61,2024-10-15 12:09:01
S8269357,1,2024-10-15 11:16:36,2,2,4,2024-10-15 11:20:36
S4452398,1,2024-10-15 11:23:44,1,1,2,2024-10-15 11:25:44
S7214005,1,2024-10-15 11:33:20,3,10,13,2024-10-15 11:46:20
S4445813,3,2024-10-15 11:42:02,1,10,11,2024-10-15 11:53:02
S4895413,1,2024-10-15 11:46:59,4,81,85,2024-10-15 13:11:59
S0161974,4,2024-10-15 11:47:48,12,12,24,2024-10-15 12:11:48
S5013741,3,2024-10-15 11:56:30,10,31,41,2024-10-15 12:37:30
S4395123,5,2024-10-15 11:59:11,3,4,7,2024-10-15 12:06:11
S2106574,5,2024-10-15 12:06:31,12,37,49,2024-10-15 12:55:31
S3374475,2,2024-10-15 12:15:44,11,36,47,2024-10-15 13:02:44
S2612979,4,2024-10-15 12:24:25,12,50,62,2024-10-15 13:26:25
S8470613,3,2024-10-15 12:41:59,6,4,10,2024-10-15 12:51:59
S6913773,3,2024-10-15 12:53:23,2,2,4,2024-10-15 12:57:23
S1260839,2,2024-10-15 13:02:49,12,19,31,2024-10-15 13:33:49
S9770803,3,2024-10-15 13:03:39,8,15,23,2024-10-15 13:26:39
S7836731,5,2024-10-15 13:07:42,1,13,14,2024-10-15 13:21:42
S3312521,1,2024-10-15 13:15:04,6,14,20,2024-10-15 13:35:04
S5516826,5,2024-10-15 13:21:58,1,6,7,2024-10-15 13:28:58
S5454432,1,2024-10-15 13:35:33,2,16,18,2024-10-15 13:53:33
S4398071,2,2024-10-15 13:36:44,4,22,26,2024-10-15 14:02:44
S7516456,3,2024-10-15 13:42:30,1,2,3,2024-10-15 13:45:30
S3339116,4,2024-10-15 13:45:21,7,6,13,2024-10-15 13:58:21
S9052230,1,2024-10-15 14:15:49,4,7,11,2024-10-15 14:26:49
S4558296,2,2024-10-15 14:17:39,1,7,8,2024-10-15 14:25:39
S1415173,3,2024-10-15 14:25:01,8,7,15,2024-10-15 14:40:01
S7580949,1,2024-10-15 14:29:04,4,37,41,2024-10-15 15:10:04
S9221991,2,2024-10-15 14:39:02,7,14,21,2024-10-15 15:00:02
S3631101,3,2024-10-15 14:41:43,2,28,30,2024-10-15 15:11:43
S7421758,4,2024-10-15 14:42:32,4,1,5,2024-10-15 14:47:32
S1748205,5,2024-10-15 14:43:10,9,10,19,2024-10-15 15:02:10
S1408175,4,2024-10-15 14:49:09,10,15,25,2024-10-15 15:14:09
S8654302,2,2024-10-15 15:00:04,2,39,41,2024-10-15 15:41:04
S2657339,5,2024-10-15 15:08:05,12,40,52,2024-10-15 16:00:05
S1973663,1,2024-10-15 15:12:22,6,19,25,2024-10-15 15:37:22
S6333285,1,2024-10-15 15:41:52,8,2,10,2024-10-15 15:51:52
S1426745,2,2024-10-15 15:42:10,4,4,8,2024-10-15 15:50:10
S2856655,3,2024-10-15 15:42:18,8,28,36,2024-10-15 16:18:18
S1812906,2,2024-10-15 15:51:16,3,25,28,2024-10-15 16:19:16
S6740775,1,2024-10-15 15:55:11,2,18,20,2024-10-15 16:15:11
S8690773,4,2024-10-15 16:01:51,6,3,9,2024-10-15 16:10:51
S5869959,5,2024-10-15 16:01:58,2,4,6,2024-10-15 16:07:58
S1251052,5,2024-10-15 16:08:55,3,25,28,2024-10-15 16:36:55
S7455824,4,2024-10-15 16:12:15,9,62,71,2024-10-15 17:23:15
S8740066,1,2024-10-15 16:18:23,1,1,2,2024-10-15 16:20:23
S7637957,1,2024-10-15 16:23:44,1,64,65,2024-10-15 17:28:44
S1760876,2,2024-10-15 16:35:47,6,10,16,2024-10-15 16:51:47
S4736245,3,2024-10-15 16:45:35,1,8,9,2024-10-15 16:54:35
S5740697,5,2024-10-15 16:51:45,7,2,9,2024-10-15 17:00:45
S0602857,2,2024-10-15 16:54:33,8,1,9,2024-10-15 17:03:33
S5865029,3,2024-10-15 17:01:21,6,22,28,2024-10-15 17:29:21
S4376419,2,2024-10-15 17:04:03,1,5,6,2024-10-15 17:10:03
S1699886,5,2024-10-15 17:05:49,13,19,32,2024-10-15 17:37:49
S2075769,2,2024-10-15 17:10:41,11,27,38,2024-10-15 17:48:41
S4847138,1,2024-10-15 17:31:56,12,3,15,2024-10-15 17:46:56
S7909439,3,2024-10-15 17:33:00,12,69,81,2024-10-15 18:54:00
S2473846,4,2024-10-15 17:38:44,8,7,15,2024-10-15 17:53:44
S5680730,5,2024-10-15 17:43:27,2,3,5,2024-10-15 17:48:27
S5129912,1,2024-10-15 17:51:28,1,6,7,2024-10-15 17:58:28
S0338696,2,2024-10-15 17:52:33,7,11,18,2024-10-15 18:10:33
S2680677,4,2024-10-15 17:54:01,6,10,16,2024-10-15 18:10:01
S3273913,1,2024-10-15 18:20:46,5,5,10,2024-10-15 18:30:46
S5888163,2,2024-10-15 18:24:12,13,84,97,2024-10-15 20:01:12
S9945936,4,2024-10-15 18:24:46,7,6,13,2024-10-15 18:37:46
S8338223,1,2024-10-15 18:31:06,17,37,54,2024-10-15 19:25:06
S4557314,4,2024-10-15 18:38:12,2,4,6,2024-10-15 18:44:12
S1963628,5,2024-10-15 18:42:25,8,23,31,2024-10-15 19:13:25
S7790939,3,2024-10-15 19:05:52,2,3,5,2024-10-15 19:10:52
S0060008,3,2024-10-15 19:13:07,9,37,46,2024-10-15 19:59:07
S2260401,4,2024-10-15 19:24:28,7,21,28,2024-10-15 19:52:28
S2881407,1,2024-10-15 19:35:32,4,12,16,2024-10-15 19:51:32
S5224026,5,2024-10-15 19:35:57,4,22,26,2024-10-15 20:01:57
S1783171,1,2024-10-15 19:54:30,3,27,30,2024-10-15 20:24:30
S8500565,4,2024-10-15 19:56:02,12,8,20,2024-10-15 20:16:02
S0910417,3,2024-10-15 19:59:08,2,34,36,2024-10-15 20:35:08
S1869274,2,2024-10-15 20:04:45,4,23,27,2024-10-15 20:31:45
S1378227,5,2024-10-15 20:07:33,3,24,27,2024-10-15 20:34:33
S9599931,4,2024-10-15 20:23:11,3,6,9,2024-10-15 20:32:11
S7734447,1,2024-10-15 20:32:49,7,2,9,2024-10-15 20:41:49
S3836884,2,2024-10-15 20:33:15,8,5,13,2024-10-15 20:46:15
S1738892,3,2024-10-15 20:39:41,2,7,9,2024-10-15 20:48:41
S3261654,1,2024-10-15 20:56:39,4,8,12,2024-10-15 21:08:39
S8258452,2,2024-10-15 20:59:01,10,3,13,2024-10-15 21:12:01
S2478616,3,2024-10-15 21:07:58,1,13,14,2024-10-15 21:21:58
S1889842,1,2024-10-15 21:13:58,12,3,15,2024-10-15 21:28:58
S9505819,2,2024-10-15 21:14:06,5,5,10,2024-10-15 21:24:06
S2651606,4,2024-10-15 21:16:48,2,4,6,2024-10-15 21:22:48
S5689237,5,2024-10-15 21:18:32,1,4,5,2024-10-15 21:23:32
S4439966,3,2024-10-15 21:22:45,3,18,21,2024-10-15 21:43:45
S3017404,2,2024-10-15 21:28:34,1,1,2,2024-10-15 21:30:34
S2289322,1,2024-10-15 21:31:05,3,4,7,2024-10-15 21:38:05
S7011707,2,2024-10-15 21:36:19,3,2,5,2024-10-15 21:41:19
S8297559,1,2024-10-15 21:43:45,10,26,36,2024-10-15 22:19:45
S4501198,2,2024-10-15 21:46:30,6,35,41,2024-10-15 22:27:30
S4962955,3,2024-10-15 21:48:54,1,1,2,2024-10-15 21:50:54
S3863311,3,2024-10-15 21:53:17,5,51,56,2024-10-15 22:49:17
S6557120,4,2024-10-15 22:07:07,1,13,14,2024-10-15 22:21:07
S6452732,5,2024-10-15 22:11:34,1,25,26,2024-10-15 22:37:34
S1434608,1,2024-10-15 22:35:32,3,7,10,2024-10-15 22:45:32
S2824789,2,2024-10-15 22:42:01,7,40,47,2024-10-15 23:29:01
S5090211,1,2024-10-15 22:46:32,5,40,45,2024-10-15 23:31:32
S8067280,3,2024-10-15 22:52:28,8,14,22,2024-10-15 23:14:28
S5410609,4,2024-10-15 22:56:52,2,49,51,2024-10-15 23:47:52
S3317783,5,2024-10-15 22:57:44,2,34,36,2024-10-15 23:33:44
S1424808,3,2024-10-15 23:15:50,11,17,28,2024-10-15 23:43:50
S2689355,1,2024-10-15 23:41:52,3,37,40,2024-10-16 00:21:52
S5229777,2,2024-10-15 23:44:21,5,6,11,2024-10-15 23:55:21
S3230604,3,2024-10-15 23:44:38,7,3,10,2024-10-15 23:54:38
S7788421,2,2024-10-15 23:56:08,3,58,61,2024-10-16 00:57:08
S3235551,3,2024-10-15 23:59:30,8,8,16,2024-10-16 00:15:30
S8507577,4,2024-10-16 00:02:21,3,1,4,2024-10-16 00:06:21
S1216463,5,2024-10-16 00:02:46,8,9,17,2024-10-16 00:19:46
S0162137,1,2024-10-16 00:23:48,2,15,17,2024-10-16 00:40:48
S8264611,3,2024-10-16 00:25:49,9,25,34,2024-10-16 00:59:49
S8653370,4,2024-10-16 00:31:43,2,3,5,2024-10-16 00:36:43
S3114436,4,2024-10-16 00:39:27,3,53,56,2024-10-16 01:35:27
S6515308,1,2024-10-16 00:42:34,6,3,9,2024-10-16 00:51:34
S3440055,5,2024-10-16 00:50:46,5,98,103,2024-10-16 02:33:46
S2946212,1,2024-10-16 00:53:35,8,3,11,2024-10-16 01:04:35
S9859611,2,2024-10-16 01:01:30,3,3,6,2024-10-16 01:07:30
S3363654,1,2024-10-16 01:06:51,11,12,23,2024-10-16 01:29:51
S1686170,2,2024-10-16 01:22:36,6,6,12,2024-10-16 01:34:36
S7091018,3,2024-10-16 01:24:32,11,9,20,2024-10-16 01:44:32
S3719160,1,2024-10-16 01:31:21,11,7,18,2024-10-16 01:49:21
S0114826,2,2024-10-16 01:41:48,1,18,19,2024-10-16 02:00:48
S3936504,3,2024-10-16 01:44:58,12,7,19,2024-10-16 02:03:58
S0481225,1,2024-10-16 02:00:50,8,38,46,2024-10-16 02:46:50
S2039579,2,2024-10-16 02:06:04,7,2,9,2024-10-16 02:15:04
S5981518,2,2024-10-16 02:19:04,4,19,23,2024-10-16 02:42:04
S9619941,3,2024-10-16 02:21:22,2,2,4,2024-10-16 02:25:22
S9372873,3,2024-10-16 02:26:08,1,9,10,2024-10-16 02:36:08
S8467126,4,2024-10-16 02:33:58,4,5,9,2024-10-16 02:42:58
S6002770,2,2024-10-16 02:43:01,2,1,3,2024-10-16 02:46:01
S7105941,3,2024-10-16 02:43:38,1,11,12,2024-10-16 02:55:38
S1217988,4,2024-10-16 02:44:11,1,19,20,2024-10-16 03:04:11
S3248492,5,2024-10-16 02:45:13,4,41,45,2024-10-16 03:30:13
S5667446,1,2024-10-16 02:48:45,7,13,20,2024-10-16 03:08:45
S0466177,2,2024-10-16 02:54:36,2,1,3,2024-10-16 02:57:36
S8796575,2,2024-10-16 03:00:02,2,8,10,2024-10-16 03:10:02
S4075529,3,2024-10-16 03:05:54,7,1,8,2024-10-16 03:13:54
S2120772,4,2024-10-16 03:08:10,10,14,24,2024-10-16 03:32:10
S8784417,1,2024-10-16 03:17:58,8,1,9,2024-10-16 03:26:58
S4469823,2,2024-10-16 03:24:33,5,30,35,2024-10-16 03:59:33
S5486162,1,2024-10-16 03:30:01,2,5,7,2024-10-16 03:37:01
S5233425,3,2024-10-16 03:30:54,10,6,16,2024-10-16 03:46:54
S1736351,4,2024-10-16 03:34:17,5,12,17,2024-10-16 03:51:17
S4662431,1,2024-10-16 03:44:18,10,51,61,2024-10-16 04:45:18
S2833799,3,2024-10-16 03:48:19,1,18,19,2024-10-16 04:07:19
S7911029,4,2024-10-16 03:51:26,9,24,33,2024-10-16 04:24:26
S4443942,2,2024-10-16 04:00:28,2,55,57,2024-10-16 04:57:28
S6813723,5,2024-10-16 04:01:50,3,34,37,2024-10-16 04:38:50
S8872814,3,2024-10-16 04:11:48,4,12,16,2024-10-16 04:27:48
S8352417,3,2024-10-16 04:29:53,1,11,12,2024-10-16 04:41:53
S2355756,4,2024-10-16 04:37:27,5,17,22,2024-10-16 04:59:27
S9656321,1,2024-10-16 04:49:45,1,1,2,2024-10-16 04:51:45
S8261328,1,2024-10-16 05:02:15,9,1,10,2024-10-16 05:12:15
S7815988,2,2024-10-16 05:10:12,5,69,74,2024-10-16 06:24:12
S6601001,1,2024-10-16 05:21:05,3,61,64,2024-10-16 06:25:05
S6529790,3,2024-10-16 05:30:52,6,7,13,2024-10-16 05:43:52
S8942790,4,2024-10-16 05:35:51,7,26,33,2024-10-16 06:08:51
S7493690,5,2024-10-16 05:37:03,8,11,19,2024-10-16 05:56:03
S0803717,3,2024-10-16 05:46:57,4,1,5,2024-10-16 05:51:57
S2908089,3,2024-10-16 05:54:43,10,13,23,2024-10-16 06:17:43
S9132699,3,2024-10-16 06:18:42,4,54,58,2024-10-16 07:16:42
S3113256,4,2024-10-16 06:18:48,7,34,41,2024-10-16 06:59:48
S8702577,5,2024-10-16 06:22:13,5,8,13,2024-10-16 06:35:13
S9291396,1,2024-10-16 06:26:53,4,12,16,2024-10-16 06:42:53
S8756471,2,2024-10-16 06:38:26,5,2,7,2024-10-16 06:45:26
S5668227,1,2024-10-16 06:46:34,4,30,34,2024-10-16 07:20:34
S3856468,2,2024-10-16 06:59:29,2,18,20,2024-10-16 07:19:29
S0930228,4,2024-10-16 07:06:34,13,15,28,2024-10-16 07:34:34
S2022192,3,2024-10-16 07:18:36,2,21,23,2024-10-16 07:41:36
S8274887,1,2024-10-16 07:22:27,5,19,24,2024-10-16 07:46:27
S3914257,2,2024-10-16 07:24:40,8,12,20,2024-10-16 07:44:40
S2305035,5,2024-10-16 07:30:10,3,48,51,2024-10-16 08:21:10
S6686848,4,2024-10-16 07:35:06,1,65,66,2024-10-16 08:41:06
S8928007,1,2024-10-16 08:03:12,5,23,28,2024-10-16 08:31:12
S9023566,2,2024-10-16 08:04:23,4,33,37,2024-10-16 08:41:23
S4101913,3,2024-10-16 08:09:43,6,22,28,2024-10-16 08:37:43
S3164904,1,2024-10-16 08:53:22,9,57,66,2024-10-16 09:59:22
S4387435,2,2024-10-16 08:56:28,4,3,7,2024-10-16 09:03:28
S0985033,3,2024-10-16 09:01:17,5,15,20,2024-10-16 09:21:17
S1885694,4,2024-10-16 09:02:21,4,1,5,2024-10-16 09:07:21
S0236887,2,2024-10-16 09:12:55,9,7,16,2024-10-16 09:28:55
S2415291,4,2024-10-16 09:13:28,4,16,20,2024-10-16 09:33:28
S9923801,5,2024-10-16 09:18:25,6,47,53,2024-10-16 10:11:25
S0924050,3,2024-10-16 09:28:27,6,19,25,2024-10-16 09:53:27
S8884891,2,2024-10-16 09:31:34,1,1,2,2024-10-16 09:33:34
S7170655,2,2024-10-16 09:42:57,1,19,20,2024-10-16 10:02:57
S9985134,4,2024-10-16 09:45:51,9,1,10,2024-10-16 09:55:51
S4904140,3,2024-10-16 09:58:12,2,12,14,2024-10-16 10:12:12
S8812353,1,2024-10-16 10:02:22,2,2,4,2024-10-16 10:06:22
S7600101,2,2024-10-16 10:03:43,3,10,13,2024-10-16 10:16:43
S2901929,1,2024-10-16 10:09:08,7,5,12,2024-10-16 10:21:08
S8944853,1,2024-10-16 10:31:56,9,99,108,2024-10-16 12:19:56
S9289668,2,2024-10-16 10:32:29,7,27,34,2024-10-16 11:06:29
S3780177,3,2024-10-16 10:39:50,5,20,25,2024-10-16 11:04:50
S1017721,2,2024-10-16 11:11:55,9,15,24,2024-10-16 11:35:55
S4698335,3,2024-10-16 11:14:31,10,18,28,2024-10-16 11:42:31
S9920399,2,2024-10-16 11:41:06,7,18,25,2024-10-16 12:06:06
S4136553,3,2024-10-16 11:47:55,5,8,13,2024-10-16 12:00:55
S3374158,4,2024-10-16 11:49:48,1,2,3,2024-10-16 11:52:48
S6573098,2,2024-10-16 12:12:36,14,4,18,2024-10-16 12:30:36
S7755623,1,2024-10-16 12:25:00,5,30,35,2024-10-16 13:00:00
S3589580,3,2024-10-16 12:26:45,3,3,6,2024-10-16 12:32:45
S1404621,4,2024-10-16 12:30:26,2,10,12,2024-10-16 12:42:26
S3288141,2,2024-10-16 12:36:11,4,8,12,2024-10-16 12:48:11
S5638272,3,2024-10-16 12:46:30,6,2,8,2024-10-16 12:54:30
S7570412,2,2024-10-16 12:52:02,2,19,21,2024-10-16 13:13:02
S6851315,3,2024-10-16 12:58:56,3,19,22,2024-10-16 13:20:56
S2115217,4,2024-10-16 12:59:09,4,18,22,2024-10-16 13:21:09
S1444065,1,2024-10-16 13:10:30,3,20,23,2024-10-16 13:33:30
S9133576,5,2024-10-16 13:12:34,1,5,6,2024-10-16 13:18:34
S6420732,2,2024-10-16 13:17:46,3,11,14,2024-10-16 13:31:46
S0434479,5,2024-10-16 13:18:58,1,6,7,2024-10-16 13:25:58
S9748814,3,2024-10-16 13:23:47,3,17,20,2024-10-16 13:43:47
S9976887,4,2024-10-16 13:26:57,5,4,9,2024-10-16 13:35:57
S5996789,1,2024-10-16 13:36:14,8,69,77,2024-10-16 14:53:14
S7384630,2,2024-10-16 13:37:27,1,14,15,2024-10-16 13:52:27
S2886181,2,2024-10-16 14:02:02,7,8,15,2024-10-16 14:17:02
S0366612,3,2024-10-16 14:05:51,6,23,29,2024-10-16 14:34:51
S9114368,4,2024-10-16 14:13:56,7,68,75,2024-10-16 15:28:56
S0786582,5,2024-10-16 14:14:22,2,64,66,2024-10-16 15:20:22
S1218762,2,2024-10-16 14:19:07,3,11,14,2024-10-16 14:33:07
S3253931,2,2024-10-16 14:39:21,4,4,8,2024-10-16 14:47:21
S5257259,3,2024-10-16 14:39:46,1,8,9,2024-10-16 14:48:46
S3185598,2,2024-10-16 14:51:42,2,9,11,2024-10-16 15:02:42
S6586967,1,2024-10-16 15:01:37,2,3,5,2024-10-16 15:06:37
S4657480,2,2024-10-16 15:05:32,9,10,19,2024-10-16 15:24:32
S1105576,1,2024-10-16 15:08:53,4,18,22,2024-10-16 15:30:53
S4153303,3,2024-10-16 15:11:21,1,24,25,2024-10-16 15:36:21
S4401299,2,2024-10-16 15:28:04,6,7,13,2024-10-16 15:41:04
S9741650,1,2024-10-16 15:32:29,5,55,60,2024-10-16 16:32:29
S0938587,4,2024-10-16 15:32:55,2,35,37,2024-10-16 16:09:55
S3155439,3,2024-10-16 15:39:43,4,3,7,2024-10-16 15:46:43
S0535847,2,2024-10-16 16:07:47,3,29,32,2024-10-16 16:39:47
S8435395,3,2024-10-16 16:11:31,3,30,33,2024-10-16 16:44:31
S3875875,4,2024-10-16 16:13:19,2,1,3,2024-10-16 16:16:19
S3203123,5,2024-10-16 16:16:17,9,8,17,2024-10-16 16:33:17
S6417339,4,2024-10-16 16:20:32,4,6,10,2024-10-16 16:30:32
S9333145,4,2024-10-16 16:32:27,2,20,22,2024-10-16 16:54:27
S1341415,1,2024-10-16 16:37:08,6,13,19,2024-10-16 16:56:08
S2831257,5,2024-10-16 16:38:03,7,22,29,2024-10-16 17:07:03
S5742889,2,2024-10-16 16:42:37,3,9,12,2024-10-16 16:54:37
S8945537,1,2024-10-16 16:59:52,2,3,5,2024-10-16 17:04:52
S9833937,1,2024-10-16 17:10:05,3,28,31,2024-10-16 17:41:05
S4744097,2,2024-10-16 17:13:23,10,8,18,2024-10-16 17:31:23
S1059548,3,2024-10-16 17:17:10,5,17,22,2024-10-16 17:39:10
S6819973,4,2024-10-16 17:31:19,4,16,20,2024-10-16 17:51:19
S8462689,2,2024-10-16 17:40:23,2,2,4,2024-10-16 17:44:23
S0963912,1,2024-10-16 17:41:43,1,29,30,2024-10-16 18:11:43
S7492857,3,2024-10-16 17:42:55,6,51,57,2024-10-16 18:39:55
S1624015,5,2024-10-16 17:43:49,13,47,60,2024-10-16 18:43:49
S4268196,2,2024-10-16 17:51:51,9,12,21,2024-10-16 18:12:51
S1647411,4,2024-10-16 17:54:45,10,9,19,2024-10-16 18:13:45
S4724308,1,2024-10-16 18:23:05,5,12,17,2024-10-16 18:40:05
S7436394,2,2024-10-16 18:38:55,1,11,12,2024-10-16 18:50:55
S8204792,1,2024-10-16 18:52:17,1,1,2,2024-10-16 18:54:17
S6456953,2,2024-10-16 18:54:16,9,7,16,2024-10-16 19:10:16
S8537638,1,2024-10-16 18:56:40,2,2,4,2024-10-16 19:00:40
S3771530,3,2024-10-16 18:57:26,3,9,12,2024-10-16 19:09:26
S3672238,4,2024-10-16 19:00:12,7,13,20,2024-10-16 19:20:12
S2412653,1,2024-10-16 19:01:14,2,11,13,2024-10-16 19:14:14
S9338249,5,2024-10-16 19:05:22,6,5,11,2024-10-16 19:16:22
S5024195,1,2024-10-16 19:38:27,7,1,8,2024-10-16 19:46:27
S8636197,2,2024-10-16 19:44:29,5,5,10,2024-10-16 19:54:29
S3618201,1,2024-10-16 19:47:41,9,23,32,2024-10-16 20:19:41
S7036101,3,2024-10-16 19:49:44,5,4,9,2024-10-16 19:58:44
S8648054,4,2024-10-16 19:52:29,8,36,44,2024-10-16 20:36:29
S6719319,2,2024-10-16 19:55:29,7,23,30,2024-10-16 20:25:29
S2955631,5,2024-10-16 19:56:16,4,8,12,2024-10-16 20:08:16
S9385946,3,2024-10-16 20:00:11,7,15,22,2024-10-16 20:22:11
S9803242,5,2024-10-16 20:19:07,8,8,16,2024-10-16 20:35:07
S9477217,1,2024-10-16 20:31:35,7,7,14,2024-10-16 20:45:35
S3976371,2,2024-10-16 20:45:05,4,35,39,2024-10-16 21:24:05
S7003727,1,2024-10-16 20:46:52,6,95,101,2024-10-16 22:27:52
S8678934,3,2024-10-16 20:48:25,3,3,6,2024-10-16 20:54:25
S7021656,4,2024-10-16 20:49:41,6,18,24,2024-10-16 21:13:41
S3275275,5,2024-10-16 20:49:49,14,3,17,2024-10-16 21:06:49
S5977983,3,2024-10-16 21:02:46,3,6,9,2024-10-16 21:11:46
S3390498,5,2024-10-16 21:08:40,10,39,49,2024-10-16 21:57:40
S9940842,3,2024-10-16 21:12:30,12,23,35,2024-10-16 21:47:30
S9583208,2,2024-10-16 21:30:29,2,44,46,2024-10-16 22:16:29
S6982315,4,2024-10-16 21:36:57,10,3,13,2024-10-16 21:49:57
S3042925,3,2024-10-16 21:55:41,8,11,19,2024-10-16 22:14:41
S2646690,4,2024-10-16 21:58:44,4,5,9,2024-10-16 22:07:44
S4940424,5,2024-10-16 21:58:50,8,27,35,2024-10-16 22:33:50
S7385273,4,2024-10-16 22:11:27,8,22,30,2024-10-16 22:41:27
S4089201,2,2024-10-16 22:17:29,5,2,7,2024-10-16 22:24:29
S4025069,3,2024-10-16 22:17:48,7,8,15,2024-10-16 22:32:48
S1699392,1,2024-10-16 22:28:15,4,42,46,2024-10-16 23:14:15
S4731095,2,2024-10-16 22:28:43,3,11,14,2024-10-16 22:42:43
S9430876,3,2024-10-16 22:42:10,11,20,31,2024-10-16 23:13:10
S6399670,2,2024-10-16 22:44:15,7,5,12,2024-10-16 22:56:15
S7586314,4,2024-10-16 22:49:55,1,1,2,2024-10-16 22:51:55
S7837607,2,2024-10-16 22:56:38,6,14,20,2024-10-16 23:16:38
S7460782,4,2024-10-16 23:02:40,1,19,20,2024-10-16 23:22:40
S3905513,5,2024-10-16 23:04:11,3,33,36,2024-10-16 23:40:11
S9085737,1,2024-10-16 23:19:31,3,41,44,2024-10-17 00:03:31
S6821321,2,2024-10-16 23:22:37,3,68,71,2024-10-17 00:33:37
S1995707,3,2024-10-16 23:36:14,8,3,11,2024-10-16 23:47:14
S4806780,4,2024-10-16 23:38:41,1,1,2,2024-10-16 23:40:41
S0946720,4,2024-10-16 23:42:38,5,4,9,2024-10-16 23:51:38
S9633242,3,2024-10-16 23:48:14,1,6,7,2024-10-16 23:55:14
S1949671,4,2024-10-16 23:52:08,4,11,15,2024-10-17 00:07:08
S1595249,1,2024-10-17 00:04:28,5,6,11,2024-10-17 00:15:28
S5167316,3,2024-10-17 00:05:44,1,121,122,2024-10-17 02:07:44
S2650419,1,2024-10-17 00:18:07,4,19,23,2024-10-17 00:41:07
S6340424,4,2024-10-17 00:21:37,10,14,24,2024-10-17 00:45:37
S3451351,2,2024-10-17 00:35:44,7,9,16,2024-10-17 00:51:44
S2244275,1,2024-10-17 00:43:33,6,2,8,2024-10-17 00:51:33
S2613475,4,2024-10-17 00:50:06,3,24,27,2024-10-17 01:17:06
S7561145,5,2024-10-17 00:50:23,1,20,21,2024-10-17 01:11:23
S9593439,1,2024-10-17 00:51:49,7,1,8,2024-10-17 00:59:49
S2067256,2,2024-10-17 00:54:06,13,46,59,2024-10-17 01:53:06
S4571038,1,2024-10-17 01:07:40,8,4,12,2024-10-17 01:19:40
S3919543,5,2024-10-17 01:14:44,3,1,4,2024-10-17 01:18:44
S5063480,4,2024-10-17 01:17:13,9,5,14,2024-10-17 01:31:13
S2792162,1,2024-10-17 01:20:00,10,16,26,2024-10-17 01:46:00
S1430091,4,2024-10-17 01:36:33,11,12,23,2024-10-17 01:59:33
S3033498,5,2024-10-17 01:36:46,6,6,12,2024-10-17 01:48:46
S8806761,1,2024-10-17 01:50:36,1,82,83,2024-10-17 03:13:36
S5227239,5,2024-10-17 01:51:11,8,4,12,2024-10-17 02:03:11
S6245153,2,2024-10-17 01:54:26,5,8,13,2024-10-17 02:07:26
S2672485,4,2024-10-17 02:00:26,1,26,27,2024-10-17 02:27:26
S0895952,5,2024-10-17 02:04:11,2,18,20,2024-10-17 02:24:11
S4708846,2,2024-10-17 02:08:28,3,59,62,2024-10-17 03:10:28
S9476560,3,2024-10-17 02:11:18,3,6,9,2024-10-17 02:20:18
S2095763,3,2024-10-17 02:28:25,4,4,8,2024-10-17 02:36:25
S5988025,3,2024-10-17 02:45:53,10,28,38,2024-10-17 03:23:53
S0254542,4,2024-10-17 02:53:27,4,9,13,2024-10-17 03:06:27
S3705853,5,2024-10-17 02:55:18,7,5,12,2024-10-17 03:07:18
S0987032,4,2024-10-17 03:07:28,5,29,34,2024-10-17 03:41:28
S8592767,1,2024-10-17 03:42:53,6,57,63,2024-10-17 04:45:53
S2476923,2,2024-10-17 03:47:49,6,54,60,2024-10-17 04:47:49
S2907911,3,2024-10-17 03:47:54,1,82,83,2024-10-17 05:10:54
S7559891,4,2024-10-17 03:48:17,3,14,17,2024-10-17 04:05:17
S0998028,5,2024-10-17 04:03:08,7,13,20,2024-10-17 04:23:08
S1873763,4,2024-10-17 04:06:43,1,1,2,2024-10-17 04:08:43
S9134665,4,2024-10-17 04:17:00,1,7,8,2024-10-17 04:25:00
S0604620,5,2024-10-17 04:23:13,4,26,30,2024-10-17 04:53:13
S9510680,4,2024-10-17 04:35:07,4,4,8,2024-10-17 04:43:07
S4599926,4,2024-10-17 04:43:48,8,34,42,2024-10-17 05:25:48
S7070406,1,2024-10-17 04:54:55,2,2,4,2024-10-17 04:58:55
S9890755,1,2024-10-17 05:08:11,4,1,5,2024-10-17 05:13:11
S1828140,2,2024-10-17 05:10:17,2,6,8,2024-10-17 05:18:17
S0813815,1,2024-10-17 05:26:23,8,30,38,2024-10-17 06:04:23
S2947774,2,2024-10-17 05:30:39,4,4,8,2024-10-17 05:38:39
S7773165,3,2024-10-17 05:33:45,9,4,13,2024-10-17 05:46:45
S7407143,4,2024-10-17 05:34:47,5,24,29,2024-10-17 06:03:47
S0163078,2,2024-10-17 05:45:06,2,2,4,2024-10-17 05:49:06
S2023161,5,2024-10-17 05:46:02,8,2,10,2024-10-17 05:56:02
S7797304,2,2024-10-17 05:50:11,1,10,11,2024-10-17 06:01:11
S2741905,3,2024-10-17 05:58:28,1,11,12,2024-10-17 06:10:28
S3495588,5,2024-10-17 05:59:00,6,3,9,2024-10-17 06:08:00
S1275298,2,2024-10-17 06:03:18,5,27,32,2024-10-17 06:35:18
S2199269,1,2024-10-17 06:08:56,15,7,22,2024-10-17 06:30:56
S3764783,3,2024-10-17 06:14:02,4,4,8,2024-10-17 06:22:02
S6789411,4,2024-10-17 06:21:18,3,4,7,2024-10-17 06:28:18
S0698849,1,2024-10-17 06:46:42,5,1,6,2024-10-17 06:52:42
S3455964,1,2024-10-17 06:55:32,6,21,27,2024-10-17 07:22:32
S5980181,2,2024-10-17 07:03:56,6,11,17,2024-10-17 07:20:56
S2783181,3,2024-10-17 07:06:13,7,4,11,2024-10-17 07:17:13
S8320593,4,2024-10-17 07:09:01,1,47,48,2024-10-17 07:57:01
S4876504,5,2024-10-17 07:16:58,5,30,35,2024-10-17 07:51:58
S1626418,2,2024-10-17 07:21:06,4,41,45,2024-10-17 08:06:06
S2279177,1,2024-10-17 07:28:32,3,2,5,2024-10-17 07:33:32
S8765769,3,2024-10-17 07:29:43,2,9,11,2024-10-17 07:40:43
S5355368,1,2024-10-17 07:36:17,7,34,41,2024-10-17 08:17:17
S7854745,3,2024-10-17 07:40:48,2,7,9,2024-10-17 07:49:48
S1858547,3,2024-10-17 07:59:19,8,7,15,2024-10-17 08:14:19
S4722037,4,2024-10-17 08:03:18,2,2,4,2024-10-17 08:07:18
S9272381,1,2024-10-17 08:17:57,3,2,5,2024-10-17 08:22:57
S6021188,1,2024-10-17 08:27:55,10,44,54,2024-10-17 09:21:55
S5701697,2,2024-10-17 08:31:15,8,81,89,2024-10-17 10:00:15
S7122696,3,2024-10-17 08:33:02,6,5,11,2024-10-17 08:44:02
S8784664,4,2024-10-17 08:33:24,2,59,61,2024-10-17 09:34:24
S5065571,5,2024-10-17 08:34:42,2,4,6,2024-10-17 08:40:42
S2598592,3,2024-10-17 08:46:35,5,9,14,2024-10-17 09:00:35
S3656333,5,2024-10-17 08:46:49,7,14,21,2024-10-17 09:07:49
S2046033,3,2024-10-17 09:05:06,12,2,14,2024-10-17 09:19:06
S7799203,5,2024-10-17 09:17:21,8,4,12,2024-10-17 09:29:21
S7539417,1,2024-10-17 09:25:42,3,34,37,2024-10-17 10:02:42
S3179413,3,2024-10-17 09:29:16,1,1,2,2024-10-17 09:31:16
S3291982,3,2024-10-17 09:34:17,1,19,20,2024-10-17 09:54:17
S9243715,4,2024-10-17 09:36:48,11,10,21,2024-10-17 09:57:48
S2147177,5,2024-10-17 09:41:51,2,3,5,2024-10-17 09:46:51
S6496489,5,2024-10-17 09:51:52,2,121,123,2024-10-17 11:54:52
S8959125,1,2024-10-17 10:06:37,6,4,10,2024-10-17 10:16:37
S2178653,2,2024-10-17 10:06:55,1,6,7,2024-10-17 10:13:55
S3790345,1,2024-10-17 10:23:52,3,3,6,2024-10-17 10:29:52
S9830097,1,2024-10-17 10:33:44,2,65,67,2024-10-17 11:40:44
S0184682,2,2024-10-17 10:36:11,2,2,4,2024-10-17 10:40:11
S4627698,2,2024-10-17 10:40:25,8,1,9,2024-10-17 10:49:25
S7087435,3,2024-10-17 10:42:23,11,32,43,2024-10-17 11:25:23
S7493642,2,2024-10-17 10:54:37,7,43,50,2024-10-17 11:44:37
S9122225,4,2024-10-17 10:59:04,3,3,6,2024-10-17 11:05:04
S0815668,4,2024-10-17 11:06:09,13,40,53,2024-10-17 11:59:09
S6062261,3,2024-10-17 11:27:43,14,67,81,2024-10-17 12:48:43
S6916042,1,2024-10-17 11:59:15,1,1,2,2024-10-17 12:01:15
S9048275,2,2024-10-17 11:59:35,6,49,55,2024-10-17 12:54:35
S4470141,1,2024-10-17 12:01:23,8,27,35,2024-10-17 12:36:23
S7591642,4,2024-10-17 12:02:52,5,4,9,2024-10-17 12:11:52
S9162666,5,2024-10-17 12:03:28,3,37,40,2024-10-17 12:43:28
S3806059,4,2024-10-17 12:13:20,5,71,76,2024-10-17 13:29:20
S7529152,1,2024-10-17 12:38:00,4,42,46,2024-10-17 13:24:00
S8376468,5,2024-10-17 12:46:19,12,9,21,2024-10-17 13:07:19
S8676298,2,2024-10-17 12:57:46,10,14,24,2024-10-17 13:21:46
S9910531,3,2024-10-17 12:59:15,11,9,20,2024-10-17 13:19:15
S4422030,5,2024-10-17 13:09:08,2,27,29,2024-10-17 13:38:08
S9656621,1,2024-10-17 13:28:06,7,44,51,2024-10-17 14:19:06
S0802572,2,2024-10-17 13:37:41,1,12,13,2024-10-17 13:50:41
S6941366,3,2024-10-17 13:38:12,8,27,35,2024-10-17 14:13:12
S8864839,4,2024-10-17 13:39:20,5,5,10,2024-10-17 13:49:20
S1608106,5,2024-10-17 13:41:28,16,26,42,2024-10-17 14:23:28
S4587085,2,2024-10-17 13:57:57,2,13,15,2024-10-17 14:12:57
S3041456,4,2024-10-17 13:59:58,6,29,35,2024-10-17 14:34:58
S1013345,1,2024-10-17 14:20:28,7,1,8,2024-10-17 14:28:28
S6414044,2,2024-10-17 14:21:07,3,14,17,2024-10-17 14:38:07
S7125390,1,2024-10-17 14:30:23,1,28,29,2024-10-17 14:59:23
S2071566,3,2024-10-17 14:35:05,1,1,2,2024-10-17 14:37:05
S2747293,2,2024-10-17 14:38:28,5,7,12,2024-10-17 14:50:28
S6243441,3,2024-10-17 14:43:25,6,4,10,2024-10-17 14:53:25
S1408239,4,2024-10-17 14:43:52,3,34,37,2024-10-17 15:20:52
S6958225,5,2024-10-17 14:46:52,1,13,14,2024-10-17 15:00:52
S8844073,1,2024-10-17 15:00:04,8,28,36,2024-10-17 15:36:04
S1020461,2,2024-10-17 15:11:49,7,38,45,2024-10-17 15:56:49
S1820006,3,2024-10-17 15:12:24,6,9,15,2024-10-17 15:27:24
S9969571,5,2024-10-17 15:12:43,6,18,24,2024-10-17 15:36:43
S9580709,4,2024-10-17 15:22:43,3,3,6,2024-10-17 15:28:43
S7527511,3,2024-10-17 15:29:08,2,7,9,2024-10-17 15:38:08
S2375718,1,2024-10-17 15:50:36,2,1,3,2024-10-17 15:53:36
S1003667,3,2024-10-17 15:52:14,2,22,24,2024-10-17 16:16:14
S1466024,1,2024-10-17 16:23:17,10,52,62,2024-10-17 17:25:17
S8941140,2,2024-10-17 16:24:08,2,13,15,2024-10-17 16:39:08
S8831549,3,2024-10-17 16:35:15,3,2,5,2024-10-17 16:40:15
S9698822,2,2024-10-17 16:43:54,9,52,61,2024-10-17 17:44:54
S9369588,3,2024-10-17 16:46:44,1,28,29,2024-10-17 17:15:44
S6803096,4,2024-10-17 16:54:49,3,8,11,2024-10-17 17:05:49
S6730455,4,2024-10-17 17:09:27,4,2,6,2024-10-17 17:15:27
S9595952,5,2024-10-17 17:09:50,2,23,25,2024-10-17 17:34:50
S3775817,3,2024-10-17 17:23:54,5,3,8,2024-10-17 17:31:54
S0176938,1,2024-10-17 17:33:21,6,3,9,2024-10-17 17:42:21
S6369291,3,2024-10-17 17:35:49,8,23,31,2024-10-17 18:06:49
S4052142,4,2024-10-17 17:36:05,7,9,16,2024-10-17 17:52:05
S7053655,5,2024-10-17 17:36:42,6,13,19,2024-10-17 17:55:42
S8882745,1,2024-10-17 17:46:41,5,20,25,2024-10-17 18:11:41
S7553140,2,2024-10-17 17:48:26,4,7,11,2024-10-17 17:59:26
S3637579,2,2024-10-17 18:08:18,1,1,2,2024-10-17 18:10:18
S0602899,1,2024-10-17 18:24:49,2,20,22,2024-10-17 18:46:49
S0499666,2,2024-10-17 18:29:10,2,1,3,2024-10-17 18:32:10
S6761879,2,2024-10-17 18:32:31,3,7,10,2024-10-17 18:42:31
S8393665,1,2024-10-17 18:49:10,10,70,80,2024-10-17 20:09:10
S5006551,2,2024-10-17 18:49:41,6,24,30,2024-10-17 19:19:41
S1371924,3,2024-10-17 19:18:29,7,87,94,2024-10-17 20:52:29
S0096210,2,2024-10-17 19:23:12,8,5,13,2024-10-17 19:36:12
S0486760,4,2024-10-17 19:24:07,3,8,11,2024-10-17 19:35:07
S0882621,5,2024-10-17 19:30:58,2,3,5,2024-10-17 19:35:58
S0260500,2,2024-10-17 19:49:26,5,86,91,2024-10-17 21:20:26
S4097616,4,2024-10-17 20:00:25,1,46,47,2024-10-17 20:47:25
S3799082,5,2024-10-17 20:04:02,5,4,9,2024-10-17 20:13:02
S5427351,1,2024-10-17 20:11:07,9,3,12,2024-10-17 20:23:07
S7246652,1,2024-10-17 20:25:15,3,4,7,2024-10-17 20:32:15
S2043675,1,2024-10-17 20:35:08,1,4,5,2024-10-17 20:40:08
S5810569,5,2024-10-17 20:38:07,7,23,30,2024-10-17 21:08:07
S2841517,1,2024-10-17 20:46:40,8,11,19,2024-10-17 21:05:40
S2964498,4,2024-10-17 20:49:08,2,3,5,2024-10-17 20:54:08
S1290773,3,2024-10-17 20:55:10,9,3,12,2024-10-17 21:07:10
S7443483,4,2024-10-17 20:55:26,9,36,45,2024-10-17 21:40:26
S8406286,1,2024-10-17 21:06:08,6,8,14,2024-10-17 21:20:08
S5912540,3,2024-10-17 21:08:03,9,4,13,2024-10-17 21:21:03
S3621131,5,2024-10-17 21:08:34,3,33,36,2024-10-17 21:44:34
S1509595,1,2024-10-17 21:28:52,5,11,16,2024-10-17 21:44:52
S6374312,2,2024-10-17 21:41:46,9,19,28,2024-10-17 22:09:46
S2988430,3,2024-10-17 21:43:34,6,1,7,2024-10-17 21:50:34
S3071561,1,2024-10-17 21:48:08,8,30,38,2024-10-17 22:26:08
S9028191,3,2024-10-17 22:01:10,3,7,10,2024-10-17 22:11:10
S7496489,2,2024-10-17 22:12:59,9,14,23,2024-10-17 22:35:59
S8146344,3,2024-10-17 22:20:09,7,14,21,2024-10-17 22:41:09
S0682698,4,2024-10-17 22:20:58,7,7,14,2024-10-17 22:34:58
S3586649,1,2024-10-17 22:28:20,1,9,10,2024-10-17 22:38:20
S4981927,5,2024-10-17 22:28:42,6,13,19,2024-10-17 22:47:42
S5159566,1,2024-10-17 22:40:48,6,13,19,2024-10-17 22:59:48
S9937639,2,2024-10-17 22:54:46,12,6,18,2024-10-17 23:12:46
S3419445,3,2024-10-17 22:56:16,10,22,32,2024-10-17 23:28:16
S5865327,4,2024-10-17 22:46:04,4,4,8,2024-10-17 22:54:04
S8509755,1,2024-10-17 23:01:04,8,13,21,2024-10-17 23:22:04
S3010419,4,2024-10-17 23:01:04,4,29,33,2024-10-17 23:34:04
S9762496,5,2024-10-17 23:01:04,6,30,36,2024-10-17 23:37:04
S0171464,2,2024-10-17 23:16:04,8,3,11,2024-10-17 23:27:04
S0578728,1,2024-10-17 23:31:04,4,24,28,2024-10-17 23:59:04
S7432916,2,2024-10-17 23:31:04,5,23,28,2024-10-17 23:59:04
S2637686,3,2024-10-17 23:31:04,2,4,6,2024-10-17 23:37:04
S2741653,3,2024-10-17 23:46:04,5,1,6,2024-10-17 23:52:04
S4179870,4,2024-10-17 23:46:04,2,34,36,2024-10-18 00:22:04
S6873410,5,2024-10-17 23:46:04,7,4,11,2024-10-17 23:57:04
S2343435,1,2024-10-18 00:01:04,5,43,48,2024-10-18 00:49:04
S7034345,2,2024-10-18 00:01:04,3,15,18,2024-10-18 00:19:04
S9257882,3,2024-10-18 00:01:04,1,8,9,2024-10-18 00:10:04
S9063212,5,2024-10-18 00:01:04,5,9,14,2024-10-18 00:15:04
S2677081,3,2024-10-18 00:16:04,7,4,11,2024-10-18 00:27:04
S9541012,5,2024-10-18 00:16:04,11,10,21,2024-10-18 00:37:04
S9580330,2,2024-10-18 00:31:04,8,4,12,2024-10-18 00:43:04
S9881965,3,2024-10-18 00:31:04,4,52,56,2024-10-18 01:27:04
S6890968,4,2024-10-18 00:31:04,7,5,12,2024-10-18 00:43:04
S6668220,2,2024-10-18 00:46:04,1,11,12,2024-10-18 00:58:04
S0925066,4,2024-10-18 00:46:04,8,21,29,2024-10-18 01:15:04
S5891667,5,2024-10-18 00:46:04,10,41,51,2024-10-18 01:37:04
S9830946,1,2024-10-18 01:01:04,5,67,72,2024-10-18 02:13:04
S4312768,2,2024-10-18 01:01:04,10,50,60,2024-10-18 02:01:04
S4092268,4,2024-10-18 01:16:04,9,56,65,2024-10-18 02:21:04
S4148906,3,2024-10-18 01:31:04,6,12,18,2024-10-18 01:49:04
S4280218,5,2024-10-18 01:46:04,5,2,7,2024-10-18 01:53:04
S4662076,2,2024-10-18 02:01:04,1,30,31,2024-10-18 02:32:04
S3330246,3,2024-10-18 02:01:04,10,12,22,2024-10-18 02:23:04
S8602307,5,2024-10-18 02:01:04,8,10,18,2024-10-18 02:19:04
S6452899,1,2024-10-18 02:16:04,9,29,38,2024-10-18 02:54:04
S3063525,3,2024-10-18 02:31:04,1,24,25,2024-10-18 02:56:04
S3624027,4,2024-10-18 02:31:04,8,20,28,2024-10-18 02:59:04
S4173461,5,2024-10-18 02:31:04,6,5,11,2024-10-18 02:42:04
S4724773,2,2024-10-18 02:46:04,9,8,17,2024-10-18 03:03:04
S8555968,5,2024-10-18 02:46:04,4,8,12,2024-10-18 02:58:04
S3288121,1,2024-10-18 03:01:04,12,11,23,2024-10-18 03:24:04
S1707498,3,2024-10-18 03:01:04,7,1,8,2024-10-18 03:09:04
S6710132,4,2024-10-18 03:01:04,4,18,22,2024-10-18 03:23:04
S3437787,5,2024-10-18 03:01:04,1,10,11,2024-10-18 03:12:04
S0533734,2,2024-10-18 03:16:04,1,6,7,2024-10-18 03:23:04
S0578452,3,2024-10-18 03:16:04,1,8,9,2024-10-18 03:25:04
S3376628,5,2024-10-18 03:16:04,5,16,21,2024-10-18 03:37:04
S2016485,1,2024-10-18 03:31:04,6,3,9,2024-10-18 03:40:04
S1478291,2,2024-10-18 03:31:04,4,42,46,2024-10-18 04:17:04
S0415274,3,2024-10-18 03:31:04,2,1,3,2024-10-18 03:34:04
S8964212,4,2024-10-18 03:31:04,7,11,18,2024-10-18 03:49:04
S4947602,1,2024-10-18 03:46:04,8,54,62,2024-10-18 04:48:04
S7185160,3,2024-10-18 03:46:04,12,41,53,2024-10-18 04:39:04
S6974562,5,2024-10-18 03:46:04,12,42,54,2024-10-18 04:40:04
S9014453,4,2024-10-18 04:01:04,1,9,10,2024-10-18 04:11:04
S3733669,4,2024-10-18 04:16:04,2,8,10,2024-10-18 04:26:04
S2574728,2,2024-10-18 04:31:04,8,7,15,2024-10-18 04:46:04
S6539365,4,2024-10-18 04:31:04,4,4,8,2024-10-18 04:39:04
S2301383,2,2024-10-18 04:46:04,2,33,35,2024-10-18 05:21:04
S6334451,3,2024-10-18 04:46:04,8,28,36,2024-10-18 05:22:04
S1710170,4,2024-10-18 04:46:04,5,32,37,2024-10-18 05:23:04
S0829905,5,2024-10-18 04:46:04,9,22,31,2024-10-18 05:17:04
S0615629,1,2024-10-18 05:01:04,11,9,20,2024-10-18 05:21:04
S3474950,1,2024-10-18 05:31:04,6,38,44,2024-10-18 06:15:04
S4913746,2,2024-10-18 05:31:04,6,13,19,2024-10-18 05:50:04
S5964381,3,2024-10-18 05:31:04,9,7,16,2024-10-18 05:47:04
S6785184,4,2024-10-18 05:31:04,13,6,19,2024-10-18 05:50:04
S3327051,5,2024-10-18 05:31:04,10,2,12,2024-10-18 05:43:04
S1634813,5,2024-10-18 05:46:04,12,27,39,2024-10-18 06:25:04
S4250599,2,2024-10-18 06:01:04,3,12,15,2024-10-18 06:16:04
S0507320,3,2024-10-18 06:01:04,6,7,13,2024-10-18 06:14:04
S8908933,4,2024-10-18 06:01:04,2,1,3,2024-10-18 06:04:04
S8244890,1,2024-10-18 06:16:04,4,4,8,2024-10-18 06:24:04
S5411226,2,2024-10-18 06:16:04,1,22,23,2024-10-18 06:39:04
S3642844,3,2024-10-18 06:16:04,3,15,18,2024-10-18 06:34:04
S8708948,4,2024-10-18 06:16:04,4,9,13,2024-10-18 06:29:04
S4736765,1,2024-10-18 06:31:04,4,16,20,2024-10-18 06:51:04
S2103195,4,2024-10-18 06:31:04,6,25,31,2024-10-18 07:02:04
S5700922,5,2024-10-18 06:31:04,4,21,25,2024-10-18 06:56:04
S1827595,2,2024-10-18 06:46:04,10,23,33,2024-10-18 07:19:04
S1682518,3,2024-10-18 06:46:04,1,8,9,2024-10-18 06:55:04
S8601535,1,2024-10-18 07:01:04,3,1,4,2024-10-18 07:05:04
S8703460,3,2024-10-18 07:01:04,9,25,34,2024-10-18 07:35:04
S9210469,5,2024-10-18 07:01:04,5,12,17,2024-10-18 07:18:04
S5768192,1,2024-10-18 07:16:04,9,5,14,2024-10-18 07:30:04
S0271513,4,2024-10-18 07:16:04,11,13,24,2024-10-18 07:40:04
S8260500,1,2024-10-18 07:31:04,8,5,13,2024-10-18 07:44:04
S0922143,2,2024-10-18 07:31:04,2,3,5,2024-10-18 07:36:04
S2959639,5,2024-10-18 07:31:04,3,5,8,2024-10-18 07:39:04
S5020082,1,2024-10-18 07:46:04,3,43,46,2024-10-18 08:32:04
S2313366,2,2024-10-18 07:46:04,1,3,4,2024-10-18 07:50:04
S2862627,3,2024-10-18 07:46:04,6,2,8,2024-10-18 07:54:04
S5644959,4,2024-10-18 07:46:04,4,12,16,2024-10-18 08:02:04
S9499073,5,2024-10-18 07:46:04,4,51,55,2024-10-18 08:41:04
S0523748,2,2024-10-18 08:01:04,10,23,33,2024-10-18 08:34:04
S5770045,3,2024-10-18 08:01:04,8,11,19,2024-10-18 08:20:04
S1602301,4,2024-10-18 08:16:04,3,3,6,2024-10-18 08:22:04
S2805574,3,2024-10-18 08:31:04,6,5,11,2024-10-18 08:42:04
S9910747,4,2024-10-18 08:31:04,3,12,15,2024-10-18 08:46:04
S8853227,1,2024-10-18 08:46:04,1,19,20,2024-10-18 09:06:04
S0372129,2,2024-10-18 08:46:04,3,31,34,2024-10-18 09:20:04
S4906590,3,2024-10-18 08:46:04,1,65,66,2024-10-18 09:52:04
S4009278,4,2024-10-18 08:46:04,8,11,19,2024-10-18 09:05:04
S7837271,5,2024-10-18 08:46:04,11,3,14,2024-10-18 09:00:04
S5970762,5,2024-10-18 09:01:04,4,26,30,2024-10-18 09:31:04
S4249047,1,2024-10-18 09:16:04,12,1,13,2024-10-18 09:29:04
S6933299,4,2024-10-18 09:16:04,12,6,18,2024-10-18 09:34:04
S5265894,1,2024-10-18 09:31:04,6,4,10,2024-10-18 09:41:04
S5079995,2,2024-10-18 09:31:04,6,24,30,2024-10-18 10:01:04
S7305428,5,2024-10-18 09:31:04,5,18,23,2024-10-18 09:54:04
S9001687,1,2024-10-18 09:46:04,3,1,4,2024-10-18 09:50:04
S7451902,4,2024-10-18 09:46:04,6,17,23,2024-10-18 10:09:04
S4072569,1,2024-10-18 10:01:04,9,7,16,2024-10-18 10:17:04
S3644258,2,2024-10-18 10:01:04,5,17,22,2024-10-18 10:23:04
S8888717,3,2024-10-18 10:01:04,4,2,6,2024-10-18 10:07:04
S1733028,5,2024-10-18 10:01:04,11,33,44,2024-10-18 10:45:04
S5972908,3,2024-10-18 10:16:04,7,13,20,2024-10-18 10:36:04
S4367623,4,2024-10-18 10:16:04,7,12,19,2024-10-18 10:35:04
S5104814,1,2024-10-18 10:31:04,6,10,16,2024-10-18 10:47:04
S5750880,2,2024-10-18 10:31:04,1,11,12,2024-10-18 10:43:04
S9087075,2,2024-10-18 10:46:04,3,75,78,2024-10-18 12:04:04
S8369109,3,2024-10-18 10:46:04,7,14,21,2024-10-18 11:07:04
S8480157,4,2024-10-18 10:46:04,12,86,98,2024-10-18 12:24:04
S6820018,5,2024-10-18 10:46:04,10,6,16,2024-10-18 11:02:04
S9926633,1,2024-10-18 11:01:04,3,21,24,2024-10-18 11:25:04
S8384184,3,2024-10-18 11:16:04,3,13,16,2024-10-18 11:32:04
S3025993,5,2024-10-18 11:16:04,4,15,19,2024-10-18 11:35:04
S2061104,1,2024-10-18 11:31:04,4,17,21,2024-10-18 11:52:04
S5427927,3,2024-10-18 11:46:04,9,6,15,2024-10-18 12:01:04
S5505373,5,2024-10-18 11:46:04,8,8,16,2024-10-18 12:02:04
S2363232,1,2024-10-18 12:01:04,8,9,17,2024-10-18 12:18:04
S3887254,3,2024-10-18 12:01:04,7,57,64,2024-10-18 13:05:04
S3152697,2,2024-10-18 12:16:04,4,51,55,2024-10-18 13:11:04
S6626112,5,2024-10-18 12:16:04,13,13,26,2024-10-18 12:42:04
S1257595,1,2024-10-18 12:31:04,6,61,67,2024-10-18 13:38:04
S2679885,4,2024-10-18 12:31:04,3,15,18,2024-10-18 12:49:04
S8686916,5,2024-10-18 12:46:04,3,10,13,2024-10-18 12:59:04
S7961246,4,2024-10-18 13:01:04,13,4,17,2024-10-18 13:18:04
S6155599,5,2024-10-18 13:01:04,6,4,10,2024-10-18 13:11:04
S5798235,2,2024-10-18 13:16:04,8,11,19,2024-10-18 13:35:04
S1457474,3,2024-10-18 13:16:04,3,10,13,2024-10-18 13:29:04
S6282094,5,2024-10-18 13:16:04,5,29,34,2024-10-18 13:50:04
S7185782,3,2024-10-18 13:31:04,4,9,13,2024-10-18 13:44:04
S1605742,4,2024-10-18 13:31:04,1,18,19,2024-10-18 13:50:04
S0646196,1,2024-10-18 13:46:04,2,25,27,2024-10-18 14:13:04
S4044561,2,2024-10-18 13:46:04,1,9,10,2024-10-18 13:56:04
S5299813,3,2024-10-18 13:46:04,3,4,7,2024-10-18 13:53:04
S5750498,2,2024-10-18 14:01:04,3,57,60,2024-10-18 15:01:04
S6902989,3,2024-10-18 14:01:04,3,4,7,2024-10-18 14:08:04
S8966268,4,2024-10-18 14:01:04,1,21,22,2024-10-18 14:23:04
S3289146,5,2024-10-18 14:01:04,8,7,15,2024-10-18 14:16:04
S2464558,1,2024-10-18 14:16:04,4,8,12,2024-10-18 14:28:04
S9656139,3,2024-10-18 14:16:04,2,2,4,2024-10-18 14:20:04
S6398617,5,2024-10-18 14:16:04,9,30,39,2024-10-18 14:55:04
S0312474,1,2024-10-18 14:31:04,12,27,39,2024-10-18 15:10:04
S4738357,3,2024-10-18 14:31:04,4,20,24,2024-10-18 14:55:04
S1680267,4,2024-10-18 14:31:04,8,57,65,2024-10-18 15:36:04
S0830750,2,2024-10-18 15:01:04,9,4,13,2024-10-18 15:14:04
S9952578,3,2024-10-18 15:01:04,1,29,30,2024-10-18 15:31:04
S9600232,5,2024-10-18 15:01:04,8,25,33,2024-10-18 15:34:04
S2535207,1,2024-10-18 15:16:04,3,19,22,2024-10-18 15:38:04
S9255104,2,2024-10-18 15:16:04,12,30,42,2024-10-18 15:58:04
S5939033,3,2024-10-18 15:31:04,4,13,17,2024-10-18 15:48:04
S1321168,1,2024-10-18 15:46:04,1,13,14,2024-10-18 16:00:04
S9873349,4,2024-10-18 15:46:04,1,13,14,2024-10-18 16:00:04
S2815542,5,2024-10-18 15:46:04,2,16,18,2024-10-18 16:04:04
S0178669,1,2024-10-18 16:01:04,6,3,9,2024-10-18 16:10:04
S2714550,2,2024-10-18 16:01:04,5,9,14,2024-10-18 16:15:04
S6267210,3,2024-10-18 16:01:04,5,3,8,2024-10-18 16:09:04
S2472199,4,2024-10-18 16:01:04,7,4,11,2024-10-18 16:12:04
S2929615,1,2024-10-18 16:16:04,8,23,31,2024-10-18 16:47:04
S4096055,2,2024-10-18 16:16:04,2,3,5,2024-10-18 16:21:04
S5749765,3,2024-10-18 16:16:04,5,84,89,2024-10-18 17:45:04
S9288680,4,2024-10-18 16:16:04,5,43,48,2024-10-18 17:04:04
S0708507,5,2024-10-18 16:16:04,2,11,13,2024-10-18 16:29:04
S4148857,2,2024-10-18 16:31:04,7,5,12,2024-10-18 16:43:04
S0676746,5,2024-10-18 16:31:04,7,14,21,2024-10-18 16:52:04
S1817881,2,2024-10-18 16:46:04,9,5,14,2024-10-18 17:00:04
S0224263,1,2024-10-18 17:01:04,7,11,18,2024-10-18 17:19:04
S3893805,2,2024-10-18 17:01:04,5,6,11,2024-10-18 17:12:04
S4085070,5,2024-10-18 17:01:04,5,7,12,2024-10-18 17:13:04
S1926288,2,2024-10-18 17:16:04,3,12,15,2024-10-18 17:31:04
S8310294,4,2024-10-18 17:16:04,8,17,25,2024-10-18 17:41:04
S4165878,5,2024-10-18 17:16:04,8,3,11,2024-10-18 17:27:04
S2164360,1,2024-10-18 17:31:04,11,14,25,2024-10-18 17:56:04
S6366386,2,2024-10-18 17:31:04,4,9,13,2024-10-18 17:44:04
S9728073,5,2024-10-18 17:31:04,10,41,51,2024-10-18 18:22:04
S7413879,2,2024-10-18 17:46:04,3,15,18,2024-10-18 18:04:04
S4495462,3,2024-10-18 17:46:04,10,31,41,2024-10-18 18:27:04
S7761362,4,2024-10-18 17:46:04,8,2,10,2024-10-18 17:56:04
S0406398,1,2024-10-18 18:01:04,2,123,125,2024-10-18 20:06:04
S6704338,4,2024-10-18 18:01:04,6,8,14,2024-10-18 18:15:04
S1172953,2,2024-10-18 18:16:04,7,63,70,2024-10-18 19:26:04
S5214281,4,2024-10-18 18:16:04,4,3,7,2024-10-18 18:23:04
S9116925,3,2024-10-18 18:31:04,9,4,13,2024-10-18 18:44:04
